N;K;count_it;start;end;result
256;10;0;300092483;300103685;11202
256;10;1;300115062;300126221;11159
256;10;2;300129152;300139819;10667
256;10;3;300142415;300153073;10658
256;10;4;300155711;300166754;11043
256;10;5;300169301;300179985;10684
256;10;6;300182537;300193621;11084
256;10;7;300196173;300206865;10692
256;10;8;300209412;300220477;11065
256;10;9;300223037;300233704;10667
256;10;10;300236242;300247282;11040
256;10;11;300249923;300260588;10665
256;10;12;300263215;300274273;11058
256;10;13;300276875;300287569;10694
256;10;14;300290161;300301246;11085
256;10;15;300303822;300314514;10692
256;10;16;300317086;300328148;11062
256;10;17;300330706;300341365;10659
256;10;18;300343937;300354984;11047
256;10;19;300357543;300368219;10676
256;10;20;300370793;300381876;11083
256;10;21;300384455;300395152;10697
256;10;22;300397721;300408794;11073
256;10;23;300411337;300422013;10676
256;10;24;300424482;300435532;11050
256;10;25;300438047;300448703;10656
256;10;26;300451232;300462286;11054
256;10;27;300464812;300475497;10685
256;10;28;300478017;300489101;11084
256;10;29;300491629;300502325;10696
256;10;30;300504870;300515931;11061
256;10;31;300518476;300529140;10664
256;10;32;300531691;300542729;11038
256;10;33;300545277;300555945;10668
256;10;34;300558498;300569573;11075
256;10;35;300572116;300582810;10694
256;10;36;300585376;300596457;11081
256;10;37;300599029;300609706;10677
256;10;38;300612272;300623329;11057
256;10;39;300625862;300636519;10657
256;10;40;300639765;300650812;11047
256;10;41;300654078;300688242;34164
256;10;42;300691893;300702581;10688
256;10;43;300705104;300715768;10664
256;10;44;300718263;300728924;10661
256;10;45;300731433;300742085;10652
256;10;46;300744583;300755257;10674
256;10;47;300757782;300768474;10692
256;10;48;300771014;300781712;10698
256;10;49;300784259;300794953;10694
256;10;50;300797489;300808164;10675
256;10;51;300810698;300821361;10663
256;10;52;300823842;300834504;10662
256;10;53;300837017;300847690;10673
256;10;54;300850165;300860851;10686
256;10;55;300863344;300874044;10700
256;10;56;300876557;300887247;10690
256;10;57;300889770;300900452;10682
256;10;58;300902995;300913665;10670
256;10;59;300916133;300926795;10662
256;10;60;300929298;300939964;10666
256;10;61;300942440;300953120;10680
256;10;62;300955591;300966289;10698
256;10;63;300968773;300979481;10708
256;10;64;300981966;300992652;10686
256;10;65;300995141;301005819;10678
256;10;66;301009026;301019692;10666
256;10;67;301022173;301032838;10665
256;10;68;301035337;301046013;10676
256;10;69;301049279;301059969;10690
256;10;70;301062448;301073150;10702
256;10;71;301076345;301087037;10692
256;10;72;301089518;301100194;10676
256;10;73;301102682;301113352;10670
256;10;74;301115817;301126470;10653
256;10;75;301128949;301139620;10671
256;10;76;301142097;301152785;10688
256;10;77;301155310;301166010;10700
256;10;78;301168499;301179195;10696
256;10;79;301181668;301192349;10681
256;10;80;301194818;301205484;10666
256;10;81;301207999;301218662;10663
256;10;82;301221125;301231794;10669
256;10;83;301234287;301244965;10678
256;10;84;301247468;301258158;10690
256;10;85;301260639;301271337;10698
256;10;86;301274536;301285224;10688
256;10;87;301287717;301298391;10674
256;10;88;301300863;301311523;10660
256;10;89;301313983;301324647;10664
256;10;90;301327834;301338508;10674
256;10;91;301341025;301351711;10686
256;10;92;301354939;301365639;10700
256;10;93;301368152;301378842;10690
256;10;94;301381327;301392002;10675
256;10;95;301394473;301405138;10665
256;10;96;301407627;301418285;10658
256;10;97;301420751;301431421;10670
256;10;98;301433914;301444596;10682
256;10;99;301447076;301457774;10698
256;10;0;301460555;301471253;10698
256;10;1;301473800;301484480;10680
256;10;2;301486973;301497638;10665
256;10;3;301500105;301510765;10660
256;10;4;301513267;301523935;10668
256;10;5;301526398;301541676;15278
256;10;6;301544493;301555185;10692
256;10;7;301557572;301568270;10698
256;10;8;301570814;301581500;10686
256;10;9;301583916;301594982;11066
256;10;10;301597554;301608205;10651
256;10;11;301610577;301621242;10665
256;10;12;301623626;301634300;10674
256;10;13;301636786;301647476;10690
256;10;14;301753955;301765171;11216
256;10;15;301768104;301778777;10673
256;10;16;301781442;301792108;10666
256;10;17;301794655;301805309;10654
256;10;18;301807887;301818558;10671
256;10;19;301821468;301832148;10680
256;10;20;301834706;301845398;10692
256;10;21;301848332;301859030;10698
256;10;22;301861594;301872276;10682
256;10;23;301875556;301886230;10674
256;10;24;301888779;301899433;10654
256;10;25;301902351;301913017;10666
256;10;26;301916273;301926955;10682
256;10;27;301929518;301940212;10694
256;10;28;301943481;301954187;10706
256;10;29;301956726;301967408;10682
256;10;30;301970322;301980992;10670
256;10;31;301984189;301994843;10654
256;10;32;301998069;302008738;10669
256;10;33;302011259;302021941;10682
256;10;34;302035811;302047104;11293
256;10;35;302050646;302061340;10694
256;10;36;302063899;302074948;11049
256;10;37;302077493;302088153;10660
256;10;38;302090700;302101743;11043
256;10;39;302104280;302114954;10674
256;10;40;302117493;302128560;11067
256;10;41;302131097;302141795;10698
256;10;42;302144340;302155407;11067
256;10;43;302157971;302168649;10678
256;10;44;302171188;302182230;11042
256;10;45;302184768;302195429;10661
256;10;46;302197934;302208985;11051
256;10;47;302211489;302222175;10686
256;10;48;302224678;302235757;11079
256;10;49;302238268;302248964;10696
256;10;50;302251507;302262566;11059
256;10;51;302265083;302275755;10672
256;10;52;302278268;302289306;11038
256;10;53;302291801;302302473;10672
256;10;54;302304972;302316030;11058
256;10;55;302318563;302329261;10698
256;10;56;302331756;302342837;11081
256;10;57;302345340;302356026;10686
256;10;58;302358527;302369579;11052
256;10;59;302372098;302382756;10658
256;10;60;302385297;302396335;11038
256;10;61;302398834;302409512;10678
256;10;62;302412007;302423076;11069
256;10;63;302425609;302436307;10698
256;10;64;302438852;302449921;11069
256;10;65;302452416;302463090;10674
256;10;66;302465627;302476667;11040
256;10;67;302479176;302489844;10668
256;10;68;302492343;302503403;11060
256;10;69;302505912;302516598;10686
256;10;70;302519087;302530166;11079
256;10;71;302532693;302543391;10698
256;10;72;302545918;302556975;11057
256;10;73;302559496;302570159;10663
256;10;74;302572636;302583678;11042
256;10;75;302586230;302596902;10672
256;10;76;302599431;302610495;11064
256;10;77;302613061;302623759;10698
256;10;78;302626266;302637345;11079
256;10;79;302639870;302650548;10678
256;10;80;302653027;302664077;11050
256;10;81;302666572;302677227;10655
256;10;82;302679765;302690811;11046
256;10;83;302693330;302704008;10678
256;10;84;302706521;302717596;11075
256;10;85;302720099;302730801;10702
256;10;86;302733298;302744366;11068
256;10;87;302746938;302757606;10668
256;10;88;302760080;302771120;11040
256;10;89;302773629;302784291;10662
256;10;90;302786812;302797867;11055
256;10;91;302800426;302811116;10690
256;10;92;302813617;302824700;11083
256;10;93;302827201;302837891;10690
256;10;94;302840388;302851450;11062
256;10;95;302853937;302864603;10666
256;10;96;302867093;302878128;11035
256;10;97;302880626;302891298;10672
256;10;98;302893803;302904870;11067
256;10;99;302907407;302918105;10698
256;10;0;302928753;302939821;11068
256;10;1;302942468;302953140;10672
256;10;2;302955610;302966650;11040
256;10;3;302969145;302979811;10666
256;10;4;302982283;302993348;11065
256;10;5;302995865;303006553;10688
256;10;6;303009060;303020143;11083
256;10;7;303022615;303033307;10692
256;10;8;303035778;303046834;11056
256;10;9;303049357;303060019;10662
256;10;10;303062496;303073544;11048
256;10;11;303076061;303086737;10676
256;10;12;303089264;303100341;11077
256;10;13;303102886;303113584;10698
256;10;14;303116156;303127235;11079
256;10;15;303129726;303140401;10675
256;10;16;303142912;303153957;11045
256;10;17;303156494;303167150;10656
256;10;18;303169679;303180735;11056
256;10;19;303183275;303193955;10680
256;10;20;303196470;303207557;11087
256;10;21;303210053;303220749;10696
256;10;22;303223252;303234313;11061
256;10;23;303236830;303247492;10662
256;10;24;303249984;303261023;11039
256;10;25;303263556;303274222;10666
256;10;26;303276724;303296851;20127
256;10;27;303300399;303311111;10712
256;10;28;303387697;303398877;11180
256;10;29;303401578;303412272;10694
256;10;30;303414836;303425521;10685
256;10;31;303428067;303438739;10672
256;10;32;303441276;303452203;10927
256;10;33;303454673;303465333;10660
256;10;34;303467787;303478457;10670
256;10;35;303481063;303491753;10690
256;10;36;303494293;303504989;10696
256;10;37;303507540;303518224;10684
256;10;38;303520775;303531445;10670
256;10;39;303534037;303544693;10656
256;10;40;303547204;303557857;10653
256;10;41;303560289;303570965;10676
256;10;42;303573474;303584156;10682
256;10;43;303586600;303597298;10698
256;10;44;303599742;303610428;10686
256;10;45;303612927;303623605;10678
256;10;46;303626039;303636703;10664
256;10;47;303639143;303649800;10657
256;10;48;303652289;303662951;10662
256;10;49;303665371;303676050;10679
256;10;50;303678470;303689158;10688
256;10;51;303691651;303702343;10692
256;10;52;303704769;303715447;10678
256;10;53;303717863;303728532;10669
256;10;54;303731009;303741667;10658
256;10;55;303744084;303754738;10654
256;10;56;303757160;303767832;10672
256;10;57;303770316;303780996;10680
256;10;58;303783377;303794074;10697
256;10;59;303796554;303807240;10686
256;10;60;303809615;303820291;10676
256;10;61;303822679;303833340;10661
256;10;62;303835793;303846450;10657
256;10;63;303848917;303859582;10665
256;10;64;303862028;303872704;10676
256;10;65;303875110;303885806;10696
256;10;66;303888189;303898877;10688
256;10;67;303901277;303911957;10680
256;10;68;303914423;303925091;10668
256;10;69;303927450;303938104;10654
256;10;70;303940491;303951153;10662
256;10;71;303953591;303964267;10676
256;10;72;303966676;303977360;10684
256;10;73;303979764;303990458;10694
256;10;74;303992985;304003671;10686
256;10;75;304006053;304016726;10673
256;10;76;304019114;304029769;10655
256;10;77;304032157;304042810;10653
256;10;78;304045259;304055920;10661
256;10;79;304058377;304069056;10679
256;10;80;304071456;304082154;10698
256;10;81;304084570;304095260;10690
256;10;82;304097674;304108351;10677
256;10;83;304110909;304121571;10662
256;10;84;304124061;304134713;10652
256;10;85;304137214;304147877;10663
256;10;86;304150309;304160983;10674
256;10;87;304163438;304174126;10688
256;10;88;304176574;304187270;10696
256;10;89;304189637;304200319;10682
256;10;90;304202753;304213419;10666
256;10;91;304215804;304226466;10662
256;10;92;304228861;304239515;10654
256;10;93;304241961;304252631;10670
256;10;94;304255014;304265694;10680
256;10;95;304268110;304278810;10700
256;10;96;304281240;304291936;10696
256;10;97;304294346;304305028;10682
256;10;98;304307395;304318063;10668
256;10;99;304320505;304331164;10659
512;10;0;304368602;304390444;21842
512;10;1;304394207;304415506;21299
512;10;2;304419029;304440310;21281
512;10;3;304443811;304465140;21329
512;10;4;304468696;304490040;21344
512;10;5;304493559;304514858;21299
512;10;6;304518548;304539838;21290
512;10;7;304543352;304564683;21331
512;10;8;304568150;304589496;21346
512;10;9;304592946;304614239;21293
512;10;10;304617710;304648794;31084
512;10;11;304653544;304674890;21346
512;10;12;304678468;304699795;21327
512;10;13;304703361;304725057;21696
512;10;14;304728601;304749920;21319
512;10;15;304754185;304775546;21361
512;10;16;304779491;304800812;21321
512;10;17;304804366;304829053;24687
512;10;18;304832564;304853898;21334
512;10;19;304857632;304878973;21341
512;10;20;304882468;304903763;21295
512;10;21;304907271;304928557;21286
512;10;22;304932103;304953435;21332
512;10;23;304956914;304978257;21343
512;10;24;304981700;305002996;21296
512;10;25;305006449;305027736;21287
512;10;26;305031253;305052599;21346
512;10;27;305056088;305077431;21343
512;10;28;305080876;305102157;21281
512;10;29;305105607;305126896;21289
512;10;30;305130389;305151729;21340
512;10;31;305155204;305176537;21333
512;10;32;305179979;305201260;21281
512;10;33;305204711;305226004;21293
512;10;34;305229543;305250891;21348
512;10;35;305254346;305275671;21325
512;10;36;305279128;305300410;21282
512;10;37;305303857;305325154;21297
512;10;38;305328659;305350011;21352
512;10;39;305353463;305374791;21328
512;10;40;305378276;305399554;21278
512;10;41;305403013;305424316;21303
512;10;42;305448405;305470241;21836
512;10;43;305473933;305495213;21280
512;10;44;305498820;305520125;21305
512;10;45;305523752;305545109;21357
512;10;46;305548718;305570047;21329
512;10;47;305573702;305594985;21283
512;10;48;305598585;305619895;21310
512;10;49;305623487;305644838;21351
512;10;50;305648488;305669809;21321
512;10;51;305673403;305694680;21277
512;10;52;305698211;305719520;21309
512;10;53;305723086;305744436;21350
512;10;54;305747933;305769252;21319
512;10;55;305772744;305794020;21276
512;10;56;305797574;305818891;21317
512;10;57;305822384;305843734;21350
512;10;58;305847219;305868534;21315
512;10;59;305872092;305903962;31870
512;10;60;305908619;305929967;21348
512;10;61;305933567;305954902;21335
512;10;62;305958468;305979753;21285
512;10;63;305983283;306004586;21303
512;10;64;306008140;306029483;21343
512;10;65;306033059;306054391;21332
512;10;66;306057973;306079254;21281
512;10;67;306082797;306104100;21303
512;10;68;306107670;306129024;21354
512;10;69;306132584;306153909;21325
512;10;70;306157461;306178740;21279
512;10;71;306182267;306203581;21314
512;10;72;306207110;306228470;21360
512;10;73;306232009;306253327;21318
512;10;74;306256870;306278151;21281
512;10;75;306282412;306303741;21329
512;10;76;306307273;306328634;21361
512;10;77;306332174;306353491;21317
512;10;78;306357035;306378322;21287
512;10;79;306382613;306403936;21323
512;10;80;306408265;306429621;21356
512;10;81;306433187;306454490;21303
512;10;82;306458062;306479351;21289
512;10;83;306482887;306504214;21327
512;10;84;306508491;306529846;21355
512;10;85;306533392;306554691;21299
512;10;86;306558229;306579520;21291
512;10;87;306583059;306604391;21332
512;10;88;306607965;306629319;21354
512;10;89;306632876;306654184;21308
512;10;90;306658039;306679326;21287
512;10;91;306682876;306704213;21337
512;10;92;306707789;306729131;21342
512;10;93;306732679;306753976;21297
512;10;94;306758258;306779555;21297
512;10;95;306783103;306804451;21348
512;10;96;306808786;306830124;21338
512;10;97;306833680;306854962;21282
512;10;98;306858508;306879811;21303
512;10;99;306883367;306904714;21347
512;10;0;306908586;306929916;21330
512;10;1;306933465;306954746;21281
512;10;2;306958274;306979579;21305
512;10;3;306983122;307004474;21352
512;10;4;307008014;307029341;21327
512;10;5;307032899;307054182;21283
512;10;6;307057709;307079022;21313
512;10;7;307082572;307103928;21356
512;10;8;307107788;307129117;21329
512;10;9;307132655;307162783;30128
512;10;10;307167387;307188725;21338
512;10;11;307192291;307213634;21343
512;10;12;307217176;307238473;21297
512;10;13;307241958;307263253;21295
512;10;14;307266746;307288085;21339
512;10;15;307291631;307312965;21334
512;10;16;307316429;307337722;21293
512;10;17;307341157;307362452;21295
512;10;18;307365888;307387229;21341
512;10;19;307390781;307412115;21334
512;10;20;307415581;307436866;21285
512;10;21;307440309;307461608;21299
512;10;22;307465072;307486416;21344
512;10;23;307489942;307511273;21331
512;10;24;307514719;307535998;21279
512;10;25;307539485;307560782;21297
512;10;26;307564281;307585631;21350
512;10;27;307589108;307610437;21329
512;10;28;307613920;307635199;21279
512;10;29;307638662;307659969;21307
512;10;30;307663423;307684773;21350
512;10;31;307688349;307709666;21317
512;10;32;307713145;307734418;21273
512;10;33;307737923;307759226;21303
512;10;34;307762675;307784028;21353
512;10;35;307787477;307808796;21319
512;10;36;307812271;307833552;21281
512;10;37;307837037;307858352;21315
512;10;38;307861898;307883249;21351
512;10;39;307886726;307908037;21311
512;10;40;307911538;307932819;21281
512;10;41;307938967;307960302;21335
512;10;42;307963905;307985666;21761
512;10;43;307989491;308010794;21303
512;10;44;308014277;308035566;21289
512;10;45;308039018;308060350;21332
512;10;46;308063863;308085208;21345
512;10;47;308088691;308109988;21297
512;10;48;308113445;308134734;21289
512;10;49;308138211;308159540;21329
512;10;50;308163084;308184436;21352
512;10;51;308187886;308209179;21293
512;10;52;308212640;308233920;21280
512;10;53;308237367;308258708;21341
512;10;54;308262246;308283588;21342
512;10;55;308287060;308308353;21293
512;10;56;308362516;308384279;21763
512;10;57;308388019;308409308;21289
512;10;58;308412941;308434628;21687
512;10;59;308438211;308469971;31760
512;10;60;308474752;308496055;21303
512;10;61;308499667;308520950;21283
512;10;62;308524601;308545930;21329
512;10;63;308549604;308570961;21357
512;10;64;308574578;308595885;21307
512;10;65;308599488;308620774;21286
512;10;66;308624389;308645724;21335
512;10;67;308649343;308670687;21344
512;10;68;308674273;308695570;21297
512;10;69;308699140;308720429;21289
512;10;70;308724013;308745358;21345
512;10;71;308748951;308770298;21347
512;10;72;308773870;308795161;21291
512;10;73;308798733;308820026;21293
512;10;74;308823604;308844950;21346
512;10;75;308848526;308869862;21336
512;10;76;308873444;308894731;21287
512;10;77;308898301;308919598;21297
512;10;78;308923202;308944550;21348
512;10;79;308948134;308969467;21333
512;10;80;308973047;308994334;21287
512;10;81;308997898;309019209;21311
512;10;82;309022781;309044133;21352
512;10;83;309047677;309069012;21335
512;10;84;309072576;309093857;21281
512;10;85;309097419;309118730;21311
512;10;86;309122326;309143684;21358
512;10;87;309147220;309168541;21321
512;10;88;309172101;309193380;21279
512;10;89;309196929;309218249;21320
512;10;90;309221835;309243197;21362
512;10;91;309247512;309268833;21321
512;10;92;309272361;309293645;21284
512;10;93;309297205;309318523;21318
512;10;94;309322105;309343465;21360
512;10;95;309347004;309368319;21315
512;10;96;309371863;309393140;21277
512;10;97;309396718;309418043;21325
512;10;98;309421625;309442977;21352
512;10;99;309446555;309467864;21309
512;10;0;309486563;309508304;21741
512;10;1;309511942;309533302;21360
512;10;2;309536834;309558534;21700
512;10;3;309562081;309583360;21279
512;10;4;309586878;309608567;21689
512;10;5;309612117;309633679;21562
512;10;6;309637217;309658540;21323
512;10;7;309662060;309683725;21665
512;10;8;309687243;309717401;30158
512;10;9;309722061;309743392;21331
512;10;10;309747013;309768310;21297
512;10;11;309771920;309793217;21297
512;10;12;309796872;309818220;21348
512;10;13;309821798;309843127;21329
512;10;14;309846726;309868010;21284
512;10;15;309871609;309892908;21299
512;10;16;309896470;309917821;21351
512;10;17;309921375;309942703;21328
512;10;18;309946252;309967533;21281
512;10;19;309971057;309992360;21303
512;10;20;309995913;310017261;21348
512;10;21;310020807;310042136;21329
512;10;22;310046387;310067671;21284
512;10;23;310071209;310092522;21313
512;10;24;310096773;310118132;21359
512;10;25;310121692;310143009;21317
512;10;26;310146533;310167806;21273
512;10;27;310171370;310192687;21317
512;10;28;310196230;310217580;21350
512;10;29;310221124;310242437;21313
512;10;30;310245989;310267274;21285
512;10;31;310270815;310292137;21322
512;10;32;310295688;310317046;21358
512;10;33;310321307;310342614;21307
512;10;34;310346151;310367436;21285
512;10;35;310371697;310393030;21333
512;10;36;310396602;310417948;21346
512;10;37;310421520;310442825;21305
512;10;38;310447069;310468356;21287
512;10;39;310471906;310493245;21339
512;10;40;310497455;310518795;21340
512;10;41;310522339;310543623;21284
512;10;42;310547870;310569165;21295
512;10;43;310572708;310594048;21340
512;10;44;310597592;310618935;21343
512;10;45;310622471;310643762;21291
512;10;46;310647643;310668934;21291
512;10;47;310672482;310693832;21350
512;10;48;310697738;310719071;21333
512;10;49;310722619;310743910;21291
512;10;50;310747438;310768741;21303
512;10;51;310772282;310793638;21356
512;10;52;310797913;310819242;21329
512;10;53;310822784;310844071;21287
512;10;54;310848325;310869640;21315
512;10;55;310873210;310894566;21356
512;10;56;310898448;310919775;21327
512;10;57;310923325;310944610;21285
512;10;58;310948530;310978587;30057
512;10;59;310983249;311004596;21347
512;10;60;311008215;311029506;21291
512;10;61;311033041;311057086;24045
512;10;62;311060624;311081968;21344
512;10;63;311085720;311107051;21331
512;10;64;311110556;311131841;21285
512;10;65;311135302;311156605;21303
512;10;66;311160157;311181504;21347
512;10;67;311185022;311206353;21331
512;10;68;311209854;311231139;21285
512;10;69;311234636;311255939;21303
512;10;70;311288572;311310420;21848
512;10;71;311314020;311335303;21283
512;10;72;311338802;311360122;21320
512;10;73;311363631;311384986;21355
512;10;74;311388508;311409817;21309
512;10;75;311413302;311434591;21289
512;10;76;311438139;311459466;21327
512;10;77;311462933;311484288;21355
512;10;78;311487747;311509048;21301
512;10;79;311512547;311533832;21285
512;10;80;311537297;311558624;21327
512;10;81;311562107;311583455;21348
512;10;82;311586966;311608275;21309
512;10;83;311611710;311632992;21282
512;10;84;311636439;311657772;21333
512;10;85;311661314;311682664;21350
512;10;86;311686102;311707399;21297
512;10;87;311710860;311732142;21282
512;10;88;311735654;311756989;21335
512;10;89;311760468;311781812;21344
512;10;90;311785291;311806577;21286
512;10;91;311810099;311831382;21283
512;10;92;311834860;311856198;21338
512;10;93;311859661;311880996;21335
512;10;94;311884513;311905812;21299
512;10;95;311909255;311930546;21291
512;10;96;311934007;311955350;21343
512;10;97;311958896;311980237;21341
512;10;98;311983716;312004997;21281
512;10;99;312008460;312029763;21303
1024;10;0;312048520;312091663;43143
1024;10;1;312097631;312140202;42571
1024;10;2;312146024;312188654;42630
1024;10;3;312194407;312246612;52205
1024;10;4;312253503;312296083;42580
1024;10;5;312301880;312344494;42614
1024;10;6;312350233;312392815;42582
1024;10;7;312399236;312441860;42624
1024;10;8;312447603;312490187;42584
1024;10;9;312495883;312538493;42610
1024;10;10;312544210;312586798;42588
1024;10;11;312592534;312635143;42609
1024;10;12;312640906;312683502;42596
1024;10;13;312689242;312731844;42602
1024;10;14;312737587;312780177;42590
1024;10;15;312785898;312828490;42592
1024;10;16;312834198;312876794;42596
1024;10;17;312882514;312925116;42602
1024;10;18;312930853;312973447;42594
1024;10;19;312979996;313022600;42604
1024;10;20;313028333;313070923;42590
1024;10;21;313077342;313119944;42602
1024;10;22;313125672;313168264;42592
1024;10;23;313174732;313217338;42606
1024;10;24;313223055;313265649;42594
1024;10;25;313271673;313314283;42610
1024;10;26;313320002;313362593;42591
1024;10;27;313369063;313411665;42602
1024;10;28;313417402;313459996;42594
1024;10;29;313466409;313518251;51842
1024;10;30;313525104;313567661;42557
1024;10;31;313573426;313616061;42635
1024;10;32;313621781;313664351;42570
1024;10;33;313670096;313712740;42644
1024;10;34;313718453;313761008;42555
1024;10;35;313766731;313809363;42632
1024;10;36;313815082;313857639;42557
1024;10;37;313863329;313905962;42633
1024;10;38;313911668;313954228;42560
1024;10;39;313959934;314005841;45907
1024;10;40;314011833;314054378;42545
1024;10;41;314059985;314102617;42632
1024;10;42;314108298;314150855;42557
1024;10;43;314156800;314199431;42631
1024;10;44;314205048;314247610;42562
1024;10;45;314253213;314295847;42634
1024;10;46;314301470;314344038;42568
1024;10;47;314349740;314392369;42629
1024;10;48;314398018;314440576;42558
1024;10;49;314446177;314488807;42630
1024;10;50;314494445;314537004;42559
1024;10;51;314542686;314585309;42623
1024;10;52;314590936;314633500;42564
1024;10;53;314639105;314681729;42624
1024;10;54;314687348;314729922;42574
1024;10;55;314735628;314787535;51907
1024;10;56;314794329;314836874;42545
1024;10;57;314842729;314885377;42648
1024;10;58;314891108;314933655;42547
1024;10;59;314939368;314982016;42648
1024;10;60;314987735;315030300;42565
1024;10;61;315036756;315079407;42651
1024;10;62;315085129;315127683;42554
1024;10;63;315133573;315176216;42643
1024;10;64;315182649;315225221;42572
1024;10;65;315230931;315273586;42655
1024;10;66;315280021;315322565;42544
1024;10;67;315328247;315370889;42642
1024;10;68;315377312;315419864;42552
1024;10;69;315425562;315468207;42645
1024;10;70;315473915;315516462;42547
1024;10;71;315522163;315564805;42642
1024;10;72;315570514;315613075;42561
1024;10;73;315619484;315662129;42645
1024;10;74;315667857;315710405;42548
1024;10;75;315716119;315758762;42643
1024;10;76;315764490;315807212;42722
1024;10;77;315813157;315855806;42649
1024;10;78;315861522;315904084;42562
1024;10;79;315909825;315952461;42636
1024;10;80;315958182;316000737;42555
1024;10;81;316015744;316058873;43129
1024;10;82;316090805;316133917;43112
1024;10;83;316139776;316182359;42583
1024;10;84;316188823;316231439;42616
1024;10;85;316237194;316279786;42592
1024;10;86;316286215;316328826;42611
1024;10;87;316334799;316377391;42592
1024;10;88;316383823;316426429;42606
1024;10;89;316432196;316474783;42587
1024;10;90;316480828;316523438;42610
1024;10;91;316530074;316572656;42582
1024;10;92;316579057;316621665;42608
1024;10;93;316627400;316670257;42857
1024;10;94;316675955;316718575;42620
1024;10;95;316725049;316767629;42580
1024;10;96;316773380;316815992;42612
1024;10;97;316821767;316864345;42578
1024;10;98;316870748;316913360;42612
1024;10;99;316922493;316968555;46062
1024;10;0;316975730;317018377;42647
1024;10;1;317024508;317067060;42552
1024;10;2;317073183;317115820;42637
1024;10;3;317121583;317164630;43047
1024;10;4;317170381;317213376;42995
1024;10;5;317219095;317261650;42555
1024;10;6;317267320;317319948;52628
1024;10;7;317326788;317369522;42734
1024;10;8;317375242;317417901;42659
1024;10;9;317423617;317466165;42548
1024;10;10;317472594;317515249;42655
1024;10;11;317520994;317563537;42543
1024;10;12;317569286;317611938;42652
1024;10;13;317617661;317660198;42537
1024;10;14;317665913;317708571;42658
1024;10;15;317714977;317757524;42547
1024;10;16;317763228;317805879;42651
1024;10;17;317812353;317854894;42541
1024;10;18;317861386;317904288;42902
1024;10;19;317909990;317952537;42547
1024;10;20;317958938;318001597;42659
1024;10;21;318007318;318049861;42543
1024;10;22;318056272;318098923;42651
1024;10;23;318105397;318147946;42549
1024;10;24;318153658;318196315;42657
1024;10;25;318202736;318245721;42985
1024;10;26;318251468;318294120;42652
1024;10;27;318300534;318343069;42535
1024;10;28;318349553;318392211;42658
1024;10;29;318397918;318440463;42545
1024;10;30;318446172;318488824;42652
1024;10;31;318494865;318546557;51692
1024;10;32;318553393;318596030;42637
1024;10;33;318601843;318644391;42548
1024;10;34;318650162;318692804;42642
1024;10;35;318699276;318741826;42550
1024;10;36;318747540;318790175;42635
1024;10;37;318796638;318839188;42550
1024;10;38;318844912;318887555;42643
1024;10;39;318893974;318936527;42553
1024;10;40;318942244;318984884;42640
1024;10;41;318991306;319033863;42557
1024;10;42;319039567;319082210;42643
1024;10;43;319088621;319131178;42557
1024;10;44;319136897;319179538;42641
1024;10;45;319185258;319227814;42556
1024;10;46;319234249;319276891;42642
1024;10;47;319282612;319325167;42555
1024;10;48;319331672;319374310;42638
1024;10;49;319380027;319422576;42549
1024;10;50;319428293;319470937;42644
1024;10;51;319477379;319519932;42553
1024;10;52;319525644;319568287;42643
1024;10;53;319574026;319616583;42557
1024;10;54;319623081;319665726;42645
1024;10;55;319671440;319713990;42550
1024;10;56;319720502;319763151;42649
1024;10;57;319768875;319820124;51249
1024;10;58;319827003;319869613;42610
1024;10;59;319875380;319917956;42576
1024;10;60;319923711;319966323;42612
1024;10;61;319972017;320014595;42578
1024;10;62;320020303;320062930;42627
1024;10;63;320068642;320111214;42572
1024;10;64;320116946;320162651;45705
1024;10;65;320168626;320211214;42588
1024;10;66;320216856;320259454;42598
1024;10;67;320265104;320307685;42581
1024;10;68;320313325;320355945;42620
1024;10;69;320361619;320404185;42566
1024;10;70;320409830;320452438;42608
1024;10;71;320458031;320500607;42576
1024;10;72;320506245;320548865;42620
1024;10;73;320554535;320597106;42571
1024;10;74;320602720;320645336;42616
1024;10;75;320650941;320693506;42565
1024;10;76;320699146;320741754;42608
1024;10;77;320747420;320789988;42568
1024;10;78;320795601;320838229;42628
1024;10;79;320843830;320886394;42564
1024;10;80;320892025;320934658;42633
1024;10;81;320940358;320982924;42566
1024;10;82;320988541;321031169;42628
1024;10;83;321036768;321089402;52634
1024;10;84;321096287;321138879;42592
1024;10;85;321144616;321187216;42600
1024;10;86;321192934;321235528;42594
1024;10;87;321241247;321283849;42602
1024;10;88;321289559;321332157;42598
1024;10;89;321337857;321380449;42592
1024;10;90;321386206;321428802;42596
1024;10;91;321435213;321477811;42598
1024;10;92;321483538;321526140;42602
1024;10;93;321553390;321596569;43179
1024;10;94;321602553;321645094;42541
1024;10;95;321650993;321693652;42659
1024;10;96;321699557;321742102;42545
1024;10;97;321748011;321791046;43035
1024;10;98;321796891;321839434;42543
1024;10;99;321845266;321888295;43029
1024;10;0;321924127;321966802;42675
1024;10;1;321972608;322015584;42976
1024;10;2;322021192;322063794;42602
1024;10;3;322069415;322112236;42821
1024;10;4;322117829;322160433;42604
1024;10;5;322166080;322209045;42965
1024;10;6;322214632;322257242;42610
1024;10;7;322262835;322305850;43015
1024;10;8;322311419;322363575;52156
1024;10;9;322370411;322412960;42549
1024;10;10;322418653;322461287;42634
1024;10;11;322467042;322509607;42565
1024;10;12;322515296;322557934;42638
1024;10;13;322563639;322606202;42563
1024;10;14;322611886;322654523;42637
1024;10;15;322660237;322702790;42553
1024;10;16;322708475;322751111;42636
1024;10;17;322756822;322799385;42563
1024;10;18;322805079;322847714;42635
1024;10;19;322853770;322896334;42564
1024;10;20;322902048;322944683;42635
1024;10;21;322951110;322993678;42568
1024;10;22;322999386;323042010;42624
1024;10;23;323048430;323090987;42557
1024;10;24;323096669;323139312;42643
1024;10;25;323145055;323187624;42569
1024;10;26;323193316;323240142;46826
1024;10;27;323246545;323289091;42546
1024;10;28;323294708;323337342;42634
1024;10;29;323342972;323385523;42551
1024;10;30;323391141;323433775;42634
1024;10;31;323439400;323481960;42560
1024;10;32;323487606;323530238;42632
1024;10;33;323535837;323587558;51721
1024;10;34;323594281;323636927;42646
1024;10;35;323642631;323685167;42536
1024;10;36;323690889;323733540;42651
1024;10;37;323739268;323781824;42556
1024;10;38;323788302;323830956;42654
1024;10;39;323836669;323879222;42553
1024;10;40;323885666;323928318;42652
1024;10;41;323934770;323977307;42537
1024;10;42;323983328;324025982;42654
1024;10;43;324032511;324075052;42541
1024;10;44;324081469;324124120;42651
1024;10;45;324129822;324172363;42541
1024;10;46;324178400;324221046;42646
1024;10;47;324226763;324269298;42535
1024;10;48;324275748;324318398;42650
1024;10;49;324324103;324366642;42539
1024;10;50;324373106;324415762;42656
1024;10;51;324422256;324464794;42538
1024;10;52;324470488;324513140;42652
1024;10;53;324519574;324562117;42543
1024;10;54;324568585;324611233;42648
1024;10;55;324616976;324659526;42550
1024;10;56;324665941;324708600;42659
1024;10;57;324714290;324756833;42543
1024;10;58;324763281;324805937;42656
1024;10;59;324811666;324863071;51405
1024;10;60;324869897;324912539;42642
1024;10;61;324918256;324960813;42557
1024;10;62;324966530;325009182;42652
1024;10;63;325015602;325058149;42547
1024;10;64;325063918;325106561;42643
1024;10;65;325112253;325154808;42555
1024;10;66;325160494;325203137;42643
1024;10;67;325208839;325251393;42554
1024;10;68;325257490;325300134;42644
1024;10;69;325305841;325348408;42567
1024;10;70;325354105;325396757;42652
1024;10;71;325402456;325445001;42545
1024;10;72;325450701;325493350;42649
1024;10;73;325499066;325541610;42544
1024;10;74;325548090;325590756;42666
1024;10;75;325596473;325639012;42539
1024;10;76;325644721;325687369;42648
1024;10;77;325693815;325736362;42547
1024;10;78;325742074;325784727;42653
1024;10;79;325791189;325833734;42545
1024;10;80;325839430;325882079;42649
1024;10;81;325887775;325930314;42539
1024;10;82;325936031;325978686;42655
1024;10;83;325984416;326026962;42546
1024;10;84;326032741;326075645;42904
1024;10;85;326082084;326134157;52073
1024;10;86;326141006;326183972;42966
1024;10;87;326189701;326232274;42573
1024;10;88;326238728;326284610;45882
1024;10;89;326290248;326332830;42582
1024;10;90;326338700;326381495;42795
1024;10;91;326387102;326429671;42569
1024;10;92;326435341;326477955;42614
1024;10;93;326483571;326526150;42579
1024;10;94;326531796;326574406;42610
1024;10;95;326580082;326622648;42566
1024;10;96;326628273;326670899;42626
1024;10;97;326676505;326719064;42559
1024;10;98;326724704;326767326;42622
1024;10;99;326772968;326815535;42567
2048;10;0;326840254;326925877;85623
2048;10;1;326936162;327021303;85141
2048;10;2;327031301;327116436;85135
2048;10;3;327126407;327211534;85127
2048;10;4;327284956;327370573;85617
2048;10;5;327380735;327476511;95776
2048;10;6;327487562;327572717;85155
2048;10;7;327582710;327667858;85148
2048;10;8;327677829;327762986;85157
2048;10;9;327772994;327858157;85163
2048;10;10;327868100;327953257;85157
2048;10;11;327963259;328048434;85175
2048;10;12;328058429;328143597;85168
2048;10;13;328153602;328238770;85168
2048;10;14;328248745;328333927;85182
2048;10;15;328344617;328429796;85179
2048;10;16;328439753;328524923;85170
2048;10;17;328535600;328620784;85184
2048;10;18;328630731;328724877;94146
2048;10;19;328736059;328821227;85168
2048;10;20;328831224;328916404;85180
2048;10;21;328926407;329011587;85180
2048;10;22;329021568;329106752;85184
2048;10;23;329116719;329201898;85179
2048;10;24;329211871;329297041;85170
2048;10;25;329307676;329392844;85168
2048;10;26;329402795;329491765;88970
2048;10;27;329502696;329830187;327491
2048;10;28;329841808;329926939;85131
2048;10;29;329937036;330022177;85141
2048;10;30;330032288;330117425;85137
2048;10;31;330127467;330222697;95230
2048;10;32;330233838;330318955;85117
2048;10;33;330328991;330414130;85139
2048;10;34;330424166;330509303;85137
2048;10;35;330519309;330604438;85129
2048;10;36;330614565;330699706;85141
2048;10;37;330709705;330794844;85139
2048;10;38;330804842;330889981;85139
2048;10;39;330899990;330985121;85131
2048;10;40;330995155;331080313;85158
2048;10;41;331090375;331175522;85147
2048;10;42;331185550;331270713;85163
2048;10;43;331280755;331365904;85149
2048;10;44;331375924;331469967;94043
2048;10;45;331481056;331566191;85135
2048;10;46;331576176;331661326;85150
2048;10;47;331671345;331756493;85148
2048;10;48;331766707;331851856;85149
2048;10;49;331861853;331947009;85156
2048;10;50;331956998;332042153;85155
2048;10;51;332052193;332137361;85168
2048;10;52;332147399;332232562;85163
2048;10;53;332242602;332327761;85159
2048;10;54;332337787;332422961;85174
2048;10;55;332432990;332518160;85170
2048;10;56;332528184;332616915;88731
2048;10;57;332626981;332721496;94515
2048;10;58;332732650;332817967;85317
2048;10;59;332828005;332913169;85164
2048;10;60;332923219;333008382;85163
2048;10;61;333018416;333103589;85173
2048;10;62;333113629;333198797;85168
2048;10;63;333208823;333293994;85171
2048;10;64;333303973;333389151;85178
2048;10;65;333399122;333484310;85188
2048;10;66;333494250;333579428;85178
2048;10;67;333589375;333674560;85185
2048;10;68;333684487;333769667;85180
2048;10;69;333780326;333865518;85192
2048;10;70;333875467;333969483;94016
2048;10;71;333980548;334065720;85172
2048;10;72;334075666;334160838;85172
2048;10;73;334170829;334256003;85174
2048;10;74;334266755;334351945;85190
2048;10;75;334361884;334447063;85179
2048;10;76;334457753;334542923;85170
2048;10;77;334552864;334638053;85189
2048;10;78;334648733;334733899;85166
2048;10;79;334743845;334829011;85166
2048;10;80;334839689;334924860;85171
2048;10;81;334934835;335019999;85164
2048;10;82;335029937;335115095;85158
2048;10;83;335125052;335219107;94055
2048;10;84;335230149;335315321;85172
2048;10;85;335325312;335410473;85161
2048;10;86;335420455;335505624;85169
2048;10;87;335515587;335600746;85159
2048;10;88;335611428;335696590;85162
2048;10;89;335706553;335791714;85161
2048;10;90;335802461;335890676;88215
2048;10;91;335900623;335985772;85149
2048;10;92;335995911;336081058;85147
2048;10;93;336090920;336176069;85149
2048;10;94;336185974;336271127;85153
2048;10;95;336281082;336366247;85165
2048;10;96;336376119;336470662;94543
2048;10;97;336481747;336566892;85145
2048;10;98;336576904;336662059;85155
2048;10;99;336672052;336757214;85162
2048;10;0;336768189;336853337;85148
2048;10;1;336863326;336948463;85137
2048;10;2;336958440;337043575;85135
2048;10;3;337053567;337138704;85137
2048;10;4;337148715;337233864;85149
2048;10;5;337243856;337328991;85135
2048;10;6;337338968;337424109;85141
2048;10;7;337434082;337519215;85133
2048;10;8;337529158;337614285;85127
2048;10;9;337625054;337719046;93992
2048;10;10;337730083;337815216;85133
2048;10;11;337825225;337910376;85151
2048;10;12;337920396;338005529;85133
2048;10;13;338016290;338101421;85131
2048;10;14;338111392;338196523;85131
2048;10;15;338236158;338321814;85656
2048;10;16;338332249;338417408;85159
2048;10;17;338427764;338512917;85153
2048;10;18;338523310;338608463;85153
2048;10;19;338618869;338704025;85156
2048;10;20;338714769;338799935;85166
2048;10;21;338810728;338895889;85161
2048;10;22;338906253;339004126;97873
2048;10;23;339015271;339100435;85164
2048;10;24;339110464;339195618;85154
2048;10;25;339205617;339290782;85165
2048;10;26;339300778;339385947;85169
2048;10;27;339395951;339481108;85157
2048;10;28;339491116;339576275;85159
2048;10;29;339586289;339671450;85161
2048;10;30;339681462;339766611;85149
2048;10;31;339776618;339861754;85136
2048;10;32;339871773;339956929;85156
2048;10;33;339966940;340052071;85131
2048;10;34;340062054;340147191;85137
2048;10;35;340157161;340251910;94749
2048;10;36;340262957;340348096;85139
2048;10;37;340358101;340443255;85154
2048;10;38;340453286;340538428;85142
2048;10;39;340548421;340633562;85141
2048;10;40;340643574;340728705;85131
2048;10;41;340738714;340823851;85137
2048;10;42;340833865;340918996;85131
2048;10;43;340929038;341014163;85125
2048;10;44;341024203;341109336;85133
2048;10;45;341119309;341204456;85147
2048;10;46;341214443;341299585;85142
2048;10;47;341309568;341394719;85151
2048;10;48;341404686;341498683;93997
2048;10;49;341509840;341594971;85131
2048;10;50;341605009;341690138;85129
2048;10;51;341700138;341785279;85141
2048;10;52;341795288;341880415;85127
2048;10;53;341890441;341975578;85137
2048;10;54;341985561;342070698;85137
2048;10;55;342080690;342168557;87867
2048;10;56;342178542;342263683;85141
2048;10;57;342273846;342359000;85154
2048;10;58;342368916;342454049;85133
2048;10;59;342463935;342549097;85162
2048;10;60;342559011;342644162;85151
2048;10;61;342654038;342748492;94454
2048;10;62;342759632;342844777;85145
2048;10;63;342854762;342939905;85143
2048;10;64;342949887;343035014;85127
2048;10;65;343045017;343130168;85151
2048;10;66;343140160;343225313;85153
2048;10;67;343235294;343320451;85157
2048;10;68;343330406;343415562;85156
2048;10;69;343426310;343511478;85168
2048;10;70;343521431;343606606;85175
2048;10;71;343616567;343701725;85158
2048;10;72;343712457;343797618;85161
2048;10;73;343808363;343893526;85163
2048;10;74;343903461;343988631;85170
2048;10;75;344007694;344093275;85581
2048;10;76;344103827;344188996;85169
2048;10;77;344198990;344284548;85558
2048;10;78;344294521;344379684;85163
2048;10;79;344389625;344475165;85540
2048;10;80;344485140;344570302;85162
2048;10;81;344580293;344665835;85542
2048;10;82;344675810;344760978;85168
2048;10;83;344770914;344856313;85399
2048;10;84;344866454;344951632;85178
2048;10;85;344961605;345047165;85560
2048;10;86;345057098;345142285;85187
2048;10;87;345152218;345240943;88725
2048;10;88;345260175;345345804;85629
2048;10;89;345356330;345441503;85173
2048;10;90;345451515;345537071;85556
2048;10;91;345547036;345632212;85176
2048;10;92;345642938;345728490;85552
2048;10;93;345738466;345823647;85181
2048;10;94;345834289;345919855;85566
2048;10;95;345929828;346015018;85190
2048;10;96;346025675;346111230;85555
2048;10;97;346121197;346206376;85179
2048;10;98;346217038;346302600;85562
2048;10;99;346312561;346397729;85168
2048;10;0;346465955;346560514;94559
2048;10;1;346571585;346656712;85127
2048;10;2;346666705;346751844;85139
2048;10;3;346761826;346846951;85125
2048;10;4;346856964;346942097;85133
2048;10;5;346952129;347037256;85127
2048;10;6;347047215;347132344;85129
2048;10;7;347142285;347227412;85127
2048;10;8;347238154;347323289;85135
2048;10;9;347333228;347418363;85135
2048;10;10;347428316;347513453;85137
2048;10;11;347523456;347608594;85138
2048;10;12;347618591;347703738;85147
2048;10;13;347713715;347807590;93875
2048;10;14;347818653;347903782;85129
2048;10;15;347913897;347999030;85133
2048;10;16;348009404;348094547;85143
2048;10;17;348104538;348189681;85143
2048;10;18;348199695;348284842;85147
2048;10;19;348294848;348386663;91815
2048;10;20;348397301;348482448;85147
2048;10;21;348492348;348577505;85157
2048;10;22;348587412;348672551;85139
2048;10;23;348682429;348767568;85139
2048;10;24;348777640;348862806;85166
2048;10;25;348872734;348957892;85158
2048;10;26;348993187;349097766;104579
2048;10;27;349109031;349194193;85162
2048;10;28;349204251;349289396;85145
2048;10;29;349299464;349384610;85146
2048;10;30;349394619;349479758;85139
2048;10;31;349489881;349575022;85141
2048;10;32;349585002;349670137;85135
2048;10;33;349680136;349765253;85117
2048;10;34;349775236;349860373;85137
2048;10;35;349871108;349956243;85135
2048;10;36;349966254;350051375;85121
2048;10;37;350061691;350146824;85133
2048;10;38;350157562;350242695;85133
2048;10;39;350252683;350346961;94278
2048;10;40;350358082;350443209;85127
2048;10;41;350453162;350538303;85141
2048;10;42;350548223;350633352;85129
2048;10;43;350643337;350728473;85136
2048;10;44;350738403;350823538;85135
2048;10;45;350833493;350918626;85133
2048;10;46;350989315;351074924;85609
2048;10;47;351085640;351170830;85190
2048;10;48;351180858;351266426;85568
2048;10;49;351276452;351364964;88512
2048;10;50;351374944;351463252;88308
2048;10;51;351473411;351558597;85186
2048;10;52;351568519;351663731;95212
2048;10;53;351674800;351759977;85177
2048;10;54;351769960;351855138;85178
2048;10;55;351865107;351950277;85170
2048;10;56;351960235;352045405;85170
2048;10;57;352055323;352140501;85178
2048;10;58;352150454;352235629;85175
2048;10;59;352245554;352330729;85175
2048;10;60;352340699;352425886;85187
2048;10;61;352435823;352520996;85173
2048;10;62;352530939;352616103;85164
2048;10;63;352626068;352711243;85175
2048;10;64;352721186;352806357;85171
2048;10;65;352816312;352910230;93918
2048;10;66;352921300;353006462;85162
2048;10;67;353016482;353101651;85169
2048;10;68;353111948;353197112;85164
2048;10;69;353207797;353292967;85170
2048;10;70;353302936;353388099;85163
2048;10;71;353398779;353483941;85162
2048;10;72;353493902;353579069;85167
2048;10;73;353589743;353674892;85149
2048;10;74;353684873;353770025;85152
2048;10;75;353780348;353865503;85155
2048;10;76;353875472;353960622;85150
2048;10;77;353970631;354055772;85141
2048;10;78;354065743;354159586;93843
2048;10;79;354170598;354255751;85153
2048;10;80;354265767;354350920;85153
2048;10;81;354360930;354446075;85145
2048;10;82;354456076;354541207;85131
2048;10;83;354551187;354636338;85151
2048;10;84;354646341;354731491;85150
2048;10;85;354742249;354827401;85152
2048;10;86;354837412;354925607;88195
2048;10;87;354936352;355021487;85135
2048;10;88;355031393;355116530;85137
2048;10;89;355126430;355211575;85145
2048;10;90;355221453;355306591;85138
2048;10;91;355316549;355410736;94187
2048;10;92;355421849;355506985;85136
2048;10;93;355517014;355602160;85146
2048;10;94;355612167;355697300;85133
2048;10;95;355707421;355792548;85127
2048;10;96;355802556;355887691;85135
2048;10;97;355897684;355982813;85129
2048;10;98;355992818;356077951;85133
2048;10;99;356087955;356173094;85139
4096;10;0;356216050;356386835;170785
4096;10;1;356405572;356575826;170254
4096;10;2;356595106;356774871;179765
4096;10;3;356794520;356964780;170260
4096;10;4;356983317;357153557;170240
4096;10;5;357172831;357343072;170241
4096;10;6;357361571;357531790;170219
4096;10;7;357551182;357721678;170496
4096;10;8;357740979;357920124;179145
4096;10;9;357939901;358113627;173726
4096;10;10;358132354;358302859;170505
4096;10;11;358321366;358491583;170217
4096;10;12;358510098;358680362;170264
4096;10;13;358698899;358869167;170268
4096;10;14;358887611;359057897;170286
4096;10;15;359076300;359256292;179992
4096;10;16;359275910;359446201;170291
4096;10;17;359464687;359634994;170307
4096;10;18;359653520;359823825;170305
4096;10;19;359842321;360012636;170315
4096;10;20;360031132;360201447;170315
4096;10;21;360219917;360390215;170298
4096;10;22;360408722;360588082;179360
4096;10;23;360607642;360777932;170290
4096;10;24;360796483;360966769;170286
4096;10;25;360985298;361158359;173061
4096;10;26;361190846;361361715;170869
4096;10;27;361380837;361551132;170295
4096;10;28;361569679;361751469;181790
4096;10;29;361771344;361941969;170625
4096;10;30;361960520;362130806;170286
4096;10;31;362149365;362319945;170580
4096;10;32;362338518;362508774;170256
4096;10;33;362527350;362697618;170268
4096;10;34;362716132;362886358;170226
4096;10;35;362904953;363084257;179304
4096;10;36;363134700;363305527;170827
4096;10;37;363324155;363494453;170298
4096;10;38;363513737;363684003;170266
4096;10;39;363702562;363872833;170271
4096;10;40;363892060;364062310;170250
4096;10;41;364080835;364264302;183467
4096;10;42;364283995;364454261;170266
4096;10;43;364472798;364643064;170266
4096;10;44;364661613;364831856;170243
4096;10;45;364850432;365020661;170229
4096;10;46;365039206;365209450;170244
4096;10;47;365228789;365399008;170219
4096;10;48;365417545;365596701;179156
4096;10;49;365616370;365786614;170244
4096;10;50;365805158;365975392;170234
4096;10;51;365993943;366164193;170250
4096;10;52;366182750;366353016;170266
4096;10;53;366371857;366542133;170276
4096;10;54;366560637;366730942;170305
4096;10;55;366759012;366929742;170730
4096;10;56;366948856;367119138;170282
4096;10;57;367137683;367311823;174140
4096;10;58;367330931;367501238;170307
4096;10;59;367519598;367690273;170675
4096;10;60;367708622;367879180;170558
4096;10;61;367897696;368077794;180098
4096;10;62;368097371;368267666;170295
4096;10;63;368286158;368456438;170280
4096;10;64;368474981;368645274;170293
4096;10;65;368663806;368834079;170273
4096;10;66;368852573;369022839;170266
4096;10;67;369041349;369211607;170258
4096;10;68;369230142;369409298;179156
4096;10;69;369428926;369599178;170252
4096;10;70;369617743;369787967;170224
4096;10;71;369806534;369976762;170228
4096;10;72;369995347;370165577;170230
4096;10;73;370184104;370354331;170227
4096;10;74;370373380;370556712;183332
4096;10;75;370576449;370746659;170210
4096;10;76;370765311;370935555;170244
4096;10;77;370954144;371124398;170254
4096;10;78;371142975;371313248;170273
4096;10;79;371331807;371502085;170278
4096;10;80;371520620;371691921;171301
4096;10;81;371710457;371890283;179826
4096;10;82;371909999;372080277;170278
4096;10;83;372098810;372269096;170286
4096;10;84;372287927;372458930;171003
4096;10;85;372477430;372647739;170309
4096;10;86;372666268;372836590;170322
4096;10;87;372855105;373035636;180531
4096;10;88;373055333;373226028;170695
4096;10;89;373244539;373415202;170663
4096;10;90;373433722;373607471;173749
4096;10;91;373626763;373797378;170615
4096;10;92;373815813;373986464;170651
4096;10;93;374004900;374175474;170574
4096;10;94;374193883;374484624;290741
4096;10;95;374504054;374674652;170598
4096;10;96;374693252;374863937;170685
4096;10;97;374882430;375052710;170280
4096;10;98;375071261;375241889;170628
4096;10;99;375260448;375430690;170242
4096;10;0;375452524;375623185;170661
4096;10;1;375652112;375823000;170888
4096;10;2;375842197;376012452;170255
4096;10;3;376031056;376201675;170619
4096;10;4;376220290;376481694;261404
4096;10;5;376501510;376674609;173099
4096;10;6;376703830;376874645;170815
4096;10;7;376893732;377073838;180106
4096;10;8;377093428;377263666;170238
4096;10;9;377282221;377452444;170223
4096;10;10;377470985;377641233;170248
4096;10;11;377659816;377830054;170238
4096;10;12;377848615;378018885;170270
4096;10;13;378037432;378207702;170270
4096;10;14;378226229;378406304;180075
4096;10;15;378425932;378596207;170275
4096;10;16;378614802;378785097;170295
4096;10;17;378803621;378973932;170311
4096;10;18;378992430;379162747;170317
4096;10;19;379181227;379357815;176588
4096;10;20;379377199;379557701;180502
4096;10;21;379577343;379747881;170538
4096;10;22;379766444;379936765;170321
4096;10;23;379955316;380125643;170327
4096;10;24;380144188;380314496;170308
4096;10;25;380333031;380503325;170294
4096;10;26;380521870;380692163;170293
4096;10;27;380710722;380890264;179542
4096;10;28;380909976;381080238;170262
4096;10;29;381098827;381269087;170260
4096;10;30;381287673;381457931;170258
4096;10;31;381476502;381646750;170248
4096;10;32;381665321;381835555;170234
4096;10;33;381854130;382033263;179133
4096;10;34;382053155;382272699;219544
4096;10;35;382292393;382472788;180395
4096;10;36;382491454;382661757;170303
4096;10;37;382680214;382850533;170319
4096;10;38;382869194;383039500;170306
4096;10;39;383057946;383228252;170306
4096;10;40;383246759;383426984;180225
4096;10;41;383446628;383616927;170299
4096;10;42;383635480;383805766;170286
4096;10;43;383824283;383994569;170286
4096;10;44;384048491;384219310;170819
4096;10;45;384238592;384408892;170300
4096;10;46;384427391;384597709;170318
4096;10;47;384626335;384797125;170790
4096;10;48;384816168;384986497;170329
4096;10;49;385005022;385175719;170697
4096;10;50;385194268;385365360;171092
4096;10;51;385383887;385554175;170288
4096;10;52;385572700;385743365;170665
4096;10;53;385761912;385944806;182894
4096;10;54;385964495;386134765;170270
4096;10;55;386153330;386323613;170283
4096;10;56;386342168;386512412;170244
4096;10;57;386530983;386701229;170246
4096;10;58;386719802;386890036;170234
4096;10;59;386908607;387078804;170197
4096;10;60;387097375;387276596;179221
4096;10;61;387296299;387466517;170218
4096;10;62;387485153;387655382;170229
4096;10;63;387673958;387844212;170254
4096;10;64;387862900;388033419;170519
4096;10;65;388052015;388222267;170252
4096;10;66;388240786;388420002;179216
4096;10;67;388439626;388609892;170266
4096;10;68;388628425;388798693;170268
4096;10;69;388817226;388990607;173381
4096;10;70;389009380;389179675;170295
4096;10;71;389198084;389368401;170317
4096;10;72;389386767;389557078;170311
4096;10;73;389575530;389755755;180225
4096;10;74;389775371;389945682;170311
4096;10;75;389964223;390134529;170306
4096;10;76;390153042;390323344;170302
4096;10;77;390341816;390512115;170299
4096;10;78;390530603;390700875;170272
4096;10;79;390719390;390898521;179131
4096;10;80;390918352;391088612;170260
4096;10;81;391107161;391277419;170258
4096;10;82;391295974;391466214;170240
4096;10;83;391484738;391654976;170238
4096;10;84;391674228;391844455;170227
4096;10;85;391862978;392033208;170230
4096;10;86;392055381;392235827;180446
4096;10;87;392255551;392425776;170225
4096;10;88;392444372;392614617;170245
4096;10;89;392633936;392804170;170234
4096;10;90;392822741;392992991;170250
4096;10;91;393011511;393181777;170266
4096;10;92;393201084;393371354;170270
4096;10;93;393389883;393569209;179326
4096;10;94;393588877;393759147;170270
4096;10;95;393777678;393947967;170289
4096;10;96;393966491;394136802;170311
4096;10;97;394155292;394325599;170307
4096;10;98;394344107;394514398;170291
4096;10;99;394532882;394712088;179206
4096;10;0;394844394;395015123;170729
4096;10;1;395033741;395208845;175104
4096;10;2;395227878;395398180;170302
4096;10;3;395416671;395586971;170300
4096;10;4;395605506;395775825;170319
4096;10;5;395794325;395973939;179614
4096;10;6;395993589;396163900;170311
4096;10;7;396182396;396352701;170305
4096;10;8;396371906;396542176;170270
4096;10;9;396560654;396730932;170278
4096;10;10;396749402;396919664;170262
4096;10;11;396938185;397108443;170258
4096;10;12;397127680;397306698;179018
4096;10;13;397326331;397496575;170244
4096;10;14;397515160;397685402;170242
4096;10;15;397703914;397874152;170238
4096;10;16;397892824;398063386;170562
4096;10;17;398081919;398254919;173000
4096;10;18;398274008;398455236;181228
4096;10;19;398474905;398645138;170233
4096;10;20;398663756;398834010;170254
4096;10;21;398852591;399022819;170228
4096;10;22;399041374;399211632;170258
4096;10;23;399230183;399400457;170274
4096;10;24;399418945;399589218;170273
4096;10;25;399607704;399786886;179182
4096;10;26;399806573;399976835;170262
4096;10;27;399995352;400165650;170298
4096;10;28;400184142;400354441;170299
4096;10;29;400373237;400543560;170323
4096;10;30;400562773;400733085;170312
4096;10;31;400751576;400921896;170320
4096;10;32;400949349;401120075;170726
4096;10;33;401139122;401309437;170315
4096;10;34;401328000;401501735;173735
4096;10;35;401520976;401692089;171113
4096;10;36;401710523;401880793;170270
4096;10;37;401899249;402069950;170701
4096;10;38;402088811;402268353;179542
4096;10;39;402288000;402458266;170266
4096;10;40;402476787;402647034;170247
4096;10;41;402665553;402835783;170230
4096;10;42;402854293;403024535;170242
4096;10;43;403043013;403213239;170226
4096;10;44;403231676;403401898;170222
4096;10;45;403420394;403599647;179253
4096;10;46;403619302;403789539;170237
4096;10;47;403808135;403978383;170248
4096;10;48;403996912;404167157;170245
4096;10;49;404185670;404355942;170272
4096;10;50;404375226;404548617;173391
4096;10;51;404567378;404746872;179494
4096;10;52;404790768;404961480;170712
4096;10;53;404980110;405150354;170244
4096;10;54;405168846;405339104;170258
4096;10;55;405357550;405569095;211545
4096;10;56;405588752;405759002;170250
4096;10;57;405777597;405947843;170246
4096;10;58;405966467;406146196;179729
4096;10;59;406165838;406336078;170240
4096;10;60;406354672;406524903;170231
4096;10;61;406543505;406713741;170236
4096;10;62;406733073;406903323;170250
4096;10;63;406921915;407092156;170241
4096;10;64;407110736;407289930;179194
4096;10;65;407309623;407479861;170238
4096;10;66;407498450;407671501;173051
4096;10;67;407690163;407860419;170256
4096;10;68;407879140;408049811;170671
4096;10;69;408068403;408238679;170276
4096;10;70;408257135;408427691;170556
4096;10;71;408446685;408627074;180389
4096;10;72;408646708;408817001;170293
4096;10;73;408835558;409005869;170311
4096;10;74;409024420;409194722;170302
4096;10;75;409213265;409383570;170305
4096;10;76;409402092;409572413;170321
4096;10;77;409590938;409761226;170288
4096;10;78;409779777;409958852;179075
4096;10;79;409978498;410148789;170291
4096;10;80;410167405;410337689;170284
4096;10;81;410356177;410526441;170264
4096;10;82;410544966;410718016;173050
4096;10;83;410736887;410910158;173271
4096;10;84;410928606;411108260;179654
4096;10;85;411127771;411298610;170839
4096;10;86;411317214;411487445;170231
4096;10;87;411505990;411676222;170232
4096;10;88;411694799;411865035;170236
4096;10;89;411883564;412053791;170227
4096;10;90;412072344;412242586;170242
4096;10;91;412261127;412440485;179358
4096;10;92;412460085;412630313;170228
4096;10;93;412648900;412819148;170248
4096;10;94;412838398;413008676;170278
4096;10;95;413027207;413197497;170290
4096;10;96;413215995;413386286;170291
4096;10;97;413405139;413584203;179064
4096;10;98;413603787;413774087;170300
4096;10;99;413792582;413962884;170302
8192;10;0;414127033;414471712;344679
8192;10;1;414507982;414848469;340487
8192;10;2;414884047;415235767;351720
8192;10;3;415272427;415612966;340539
8192;10;4;415648452;415989010;340558
8192;10;5;416024515;416375441;350926
8192;10;6;416412197;416752755;340558
8192;10;7;416788349;417128862;340513
8192;10;8;417164446;417519329;354883
8192;10;9;417556060;417896540;340480
8192;10;10;417932154;418272591;340437
8192;10;11;418308208;418648659;340451
8192;10;12;418693355;419035090;341735
8192;10;13;419071435;419411924;340489
8192;10;14;419447437;419788427;340990
8192;10;15;419823955;420174867;350912
8192;10;16;420211648;420555655;344007
8192;10;17;420591380;420932365;340985
8192;10;18;420967930;421319772;351842
8192;10;19;421356418;421696924;340506
8192;10;20;421732493;422072955;340462
8192;10;21;422108566;422449009;340443
8192;10;22;422494983;422836056;341073
8192;10;23;422872400;423212868;340468
8192;10;24;423248475;423631868;383393
8192;10;25;423668977;424020563;351586
8192;10;26;424057623;424398084;340461
8192;10;27;424433803;424774244;340441
8192;10;28;424809880;425160474;350594
8192;10;29;425197327;425537831;340504
8192;10;30;425573410;425913967;340557
8192;10;31;425949552;426300002;350450
8192;10;32;426336791;426680320;343529
8192;10;33;426716004;427056966;340962
8192;10;34;427092587;427433107;340520
8192;10;35;427468636;427821053;352417
8192;10;36;427858050;428233075;375025
8192;10;37;428269849;428610412;340563
8192;10;38;428645989;428998303;352314
8192;10;39;429035320;429375840;340520
8192;10;40;429411480;429755833;344353
8192;10;41;429791892;430143301;351409
8192;10;42;430180153;430520607;340454
8192;10;43;430556281;430896736;340455
8192;10;44;430932348;431273269;340921
8192;10;45;431308838;431660216;351378
8192;10;46;431697121;432037666;340545
8192;10;47;432073259;432413812;340553
8192;10;48;432449427;432800862;351435
8192;10;49;432840633;433181491;340858
8192;10;50;433217299;433558208;340909
8192;10;51;433593836;433946973;353137
8192;10;52;433983725;434324194;340469
8192;10;53;434359802;434700255;340453
8192;10;54;434735873;435076761;340888
8192;10;55;435122545;435463751;341206
8192;10;56;435500177;435840654;340477
8192;10;57;435876221;436220164;343943
8192;10;58;436256630;436607678;351048
8192;10;59;436644397;436984945;340548
8192;10;60;437057268;437398230;340962
8192;10;61;437433942;437785250;351308
8192;10;62;437822076;438162627;340551
8192;10;63;438198179;438538833;340654
8192;10;64;438574431;438925689;351258
8192;10;65;438962398;439306796;344398
8192;10;66;439342572;439683501;340929
8192;10;67;439719056;440059954;340898
8192;10;68;440095519;440447871;352352
8192;10;69;440484787;440825236;340449
8192;10;70;440860840;441201273;340433
8192;10;71;441236921;441587770;350849
8192;10;72;441624678;441965163;340485
8192;10;73;442000743;442347350;346607
8192;10;74;442383300;442734803;351503
8192;10;75;442771486;443112036;340550
8192;10;76;443147427;443488441;341014
8192;10;77;443523921;443864885;340964
8192;10;78;443900415;444251692;351277
8192;10;79;444288553;444629027;340474
8192;10;80;444708676;445058788;350112
8192;10;81;445095275;445446827;351552
8192;10;82;445483635;445824192;340557
8192;10;83;445859735;446200269;340534
8192;10;84;446235844;446586301;350457
8192;10;85;446623060;446963532;340472
8192;10;86;446999180;447339621;340441
8192;10;87;447375263;447715710;340447
8192;10;88;447768913;448109939;341026
8192;10;89;448149576;448490169;340593
8192;10;90;448525815;448866756;340941
8192;10;91;448902356;449254716;352360
8192;10;92;449291674;449632188;340514
8192;10;93;449667737;450008289;340552
8192;10;94;450043836;450394667;350831
8192;10;95;450431405;450771953;340548
8192;10;96;450807512;451148018;340506
8192;10;97;451183605;451534179;350574
8192;10;98;451574625;451915742;341117
8192;10;99;451951425;452292688;341263
8192;10;0;452332074;452672535;340461
8192;10;1;452708110;453061307;353197
8192;10;2;453098233;453438672;340439
8192;10;3;453474253;453814765;340512
8192;10;4;453850293;454202182;351889
8192;10;5;454238879;454579429;340550
8192;10;6;454614923;454958793;343870
8192;10;7;454995103;455346214;351111
8192;10;8;455382911;455723445;340534
8192;10;9;455758939;456099427;340488
8192;10;10;456135297;456475750;340453
8192;10;11;456511340;456862228;350888
8192;10;12;456899170;457239619;340449
8192;10;13;457275176;457615651;340475
8192;10;14;457651220;458006069;354849
8192;10;15;458042748;458383859;341111
8192;10;16;458419402;458761607;342205
8192;10;17;458797109;459149281;352172
8192;10;18;459185986;459526869;340883
8192;10;19;459562395;459902927;340532
8192;10;20;459938513;460279344;340831
8192;10;21;460324937;460666348;341411
8192;10;22;460705745;461046269;340524
8192;10;23;461083241;461423690;340449
8192;10;24;461459257;461811397;352140
8192;10;25;462117275;462954258;836983
8192;10;26;462995609;463336149;340540
8192;10;27;463372263;463732459;360196
8192;10;28;463769476;464110011;340535
8192;10;29;464145950;464486772;340822
8192;10;30;464522813;464875210;352397
8192;10;31;464912083;465252637;340554
8192;10;32;465288301;465628801;340500
8192;10;33;465664409;466014602;350193
8192;10;34;466052178;466392629;340451
8192;10;35;466428391;466768817;340426
8192;10;36;466804439;467148535;344096
8192;10;37;467184175;467535705;351530
8192;10;38;467572487;467961771;389284
8192;10;39;467998523;468338984;340461
8192;10;40;468374661;468725597;350936
8192;10;41;468762458;469102875;340417
8192;10;42;469138529;469478970;340441
8192;10;43;469514634;469865350;350716
8192;10;44;469902199;470283260;381061
8192;10;45;470321783;470662204;340421
8192;10;46;470697852;471038305;340453
8192;10;47;471073854;471425965;352111
8192;10;48;471462664;471803160;340496
8192;10;49;471838786;472179328;340542
8192;10;50;472214846;472565809;350963
8192;10;51;472602411;472942953;340542
8192;10;52;472978541;473319091;340550
8192;10;53;473358319;473713806;355487
8192;10;54;473750661;474091211;340550
8192;10;55;474126784;474467246;340462
8192;10;56;474502827;474843718;340891
8192;10;57;474889304;475230938;341634
8192;10;58;475267250;475607710;340460
8192;10;59;475643390;476034713;391323
8192;10;60;476071435;476429594;358159
8192;10;61;476466261;476806761;340500
8192;10;62;476842425;477182900;340475
8192;10;63;477218484;477569562;351078
8192;10;64;477606435;477946872;340437
8192;10;65;477982496;478323401;340905
8192;10;66;478359049;478709272;350223
8192;10;67;478746721;479087227;340506
8192;10;68;479170318;479511264;340946
8192;10;69;479550895;479891955;341060
8192;10;70;479927757;480316049;388292
8192;10;71;480353072;480693623;340551
8192;10;72;480729301;481069849;340548
8192;10;73;481105522;481456580;351058
8192;10;74;481493473;481833918;340445
8192;10;75;481869597;482210084;340487
8192;10;76;482245680;482596361;350681
8192;10;77;482633087;482976763;343676
8192;10;78;483012578;483353559;340981
8192;10;79;483389108;483730098;340990
8192;10;80;483765635;484117786;352151
8192;10;81;484154696;484495236;340540
8192;10;82;484530870;484871356;340486
8192;10;83;484906971;485257476;350505
8192;10;84;485294307;485634778;340471
8192;10;85;485670431;486014201;343770
8192;10;86;486050952;486402347;351395
8192;10;87;486439147;486779618;340471
8192;10;88;486815198;487155711;340513
8192;10;89;487191285;487531815;340530
8192;10;90;487577171;487918480;341309
8192;10;91;487954872;488295434;340562
8192;10;92;488331007;488671910;340903
8192;10;93;488707479;489061405;353926
8192;10;94;489098179;489438660;340481
8192;10;95;489474316;489814779;340463
8192;10;96;489850419;490202273;351854
8192;10;97;490239057;490579490;340433
8192;10;98;490615106;490956037;340931
8192;10;99;490991606;491342259;350653
8192;10;0;491597049;491937915;340866
8192;10;1;491973739;492317436;343697
8192;10;2;492353315;492703567;350252
8192;10;3;492740230;493080758;340528
8192;10;4;493116323;493456878;340555
8192;10;5;493492402;493841838;349436
8192;10;6;493878454;494218994;340540
8192;10;7;494254558;494595082;340524
8192;10;8;494630608;494971110;340502
8192;10;9;495007129;495359884;352755
8192;10;10;495396574;495737412;340838
8192;10;11;495773052;496113516;340464
8192;10;12;496149113;496499894;350781
8192;10;13;496536524;496877048;340524
8192;10;14;496912613;497253182;340569
8192;10;15;497288678;497640811;352133
8192;10;16;497677474;498018042;340568
8192;10;17;498053587;498397228;343641
8192;10;18;498433619;498810226;376607
8192;10;19;498846946;499197283;350337
8192;10;20;499233978;499574518;340540
8192;10;21;499610101;499950644;340543
8192;10;22;499986203;500335954;349751
8192;10;23;500372658;500713159;340501
8192;10;24;500748854;501089301;340447
8192;10;25;501124945;501477939;352994
8192;10;26;501514662;501855103;340441
8192;10;27;501890745;502231211;340466
8192;10;28;502266784;502607290;340506
8192;10;29;502642879;502992536;349657
8192;10;30;503029186;503369751;340565
8192;10;31;503405421;503745949;340528
8192;10;32;503781496;504131214;349718
8192;10;33;504167892;504514333;346441
8192;10;34;504550259;504890763;340504
8192;10;35;504926305;505277228;350923
8192;10;36;505313911;505654358;340447
8192;10;37;505689984;506030431;340447
8192;10;38;506066119;506406619;340500
8192;10;39;506451434;506792363;340929
8192;10;40;506828534;507213768;385234
8192;10;41;507250546;507597185;346639
8192;10;42;507633054;507983707;350653
8192;10;43;508020414;508360876;340462
8192;10;44;508396445;508736910;340465
8192;10;45;508772449;509121897;349448
8192;10;46;509158551;509499102;340551
8192;10;47;509534665;509875225;340560
8192;10;48;509910691;510260129;349438
8192;10;49;510296705;510637213;340508
8192;10;50;510672814;511016752;343938
8192;10;51;511052263;511392704;340441
8192;10;52;511428435;511779195;350760
8192;10;53;511815902;512156331;340429
8192;10;54;512191969;512532463;340494
8192;10;55;512568062;512917476;349414
8192;10;56;512954114;513294675;340561
8192;10;57;513330274;513670818;340544
8192;10;58;513706355;514059331;352976
8192;10;59;514096010;514436560;340550
8192;10;60;514472143;514812649;340506
8192;10;61;514848202;515188659;340457
8192;10;62;515224301;515573942;349641
8192;10;63;515610645;515951088;340443
8192;10;64;515986700;516327173;340473
8192;10;65;516362748;516712340;349592
8192;10;66;516748989;517123466;374477
8192;10;67;517160302;517500752;340450
8192;10;68;517536477;517886382;349905
8192;10;69;517923029;518263512;340483
8192;10;70;518299023;518639567;340544
8192;10;71;518674986;519015986;341000
8192;10;72;519051529;519401753;350224
8192;10;73;519438296;519778840;340544
8192;10;74;519814438;520157732;343294
8192;10;75;520193524;520544140;350616
8192;10;76;520715710;521056692;340982
8192;10;77;521092581;521433129;340548
8192;10;78;521468739;521818770;350031
8192;10;79;521855476;522195963;340487
8192;10;80;522231581;522572022;340441
8192;10;81;522607690;522948119;340429
8192;10;82;522993475;523337251;343776
8192;10;83;523373039;523713903;340864
8192;10;84;523749661;524090573;340912
8192;10;85;524126159;524477824;351665
8192;10;86;524514440;524854987;340547
8192;10;87;524890566;525231130;340564
8192;10;88;525266764;525616409;349645
8192;10;89;525653027;525993563;340536
8192;10;90;526029209;526372499;343290
8192;10;91;526408318;526758946;350628
8192;10;92;526795587;527136050;340463
8192;10;93;527171700;527512161;340461
8192;10;94;527547732;527888220;340488
8192;10;95;527923769;528273160;349391
8192;10;96;528309809;528650347;340538
8192;10;97;528685959;529026515;340556
8192;10;98;529061983;529415058;353075
8192;10;99;529451708;529792238;340530
16384;10;0;529951156;530714259;763103
16384;10;1;530792515;531545180;752665
16384;10;2;531622200;532416239;794039
16384;10;3;532494137;533257526;763389
16384;10;4;533335500;534088213;752713
16384;10;5;534165088;534933375;768287
16384;10;6;535011240;535774615;763375
16384;10;7;535852547;536605243;752696
16384;10;8;536682019;537444466;762447
16384;10;9;537522390;538287680;765290
16384;10;10;538365602;539118273;752671
16384;10;11;539195137;539956930;761793
16384;10;12;540035002;540796821;761819
16384;10;13;540874739;541630627;755888
16384;10;14;541707612;542469874;762262
16384;10;15;542547772;543309638;761866
16384;10;16;543387542;544140194;752652
16384;10;17;544217059;544982990;765931
16384;10;18;545061012;545823212;762200
16384;10;19;545901075;546653713;752638
16384;10;20;546730553;547503040;772487
16384;10;21;547581272;548344411;763139
16384;10;22;548422267;549174975;752708
16384;10;23;549251869;550014476;762607
16384;10;24;550092408;550857864;765456
16384;10;25;550935794;551688527;752733
16384;10;26;551765368;552527148;761780
16384;10;27;552605030;553367051;762021
16384;10;28;553444919;554242799;797880
16384;10;29;554322199;555091839;769640
16384;10;30;555170109;555940103;769994
16384;10;31;556018799;556783880;765081
16384;10;32;556861112;557632611;771499
16384;10;33;557710936;558475989;765053
16384;10;34;558554810;559310463;755653
16384;10;35;559387320;560155092;767772
16384;10;36;560233089;561181484;948395
16384;10;37;561311386;562093921;782535
16384;10;38;562174192;562970132;795940
16384;10;39;563050306;563820116;769810
16384;10;40;563899295;564679394;780099
16384;10;41;564759064;565538765;779701
16384;10;42;565618447;566394832;776385
16384;10;43;566473720;567254173;780453
16384;10;44;567333906;568113705;779799
16384;10;45;568193409;569032986;839577
16384;10;46;569117350;569880199;762849
16384;10;47;569958235;570720121;761886
16384;10;48;570798031;571550654;752623
16384;10;49;571627677;572389462;761785
16384;10;50;572470622;573233608;762986
16384;10;51;573311513;574064169;752656
16384;10;52;574141018;574904267;763249
16384;10;53;574982128;575747056;764928
16384;10;54;575824964;576577668;752704
16384;10;55;576654588;577417924;763336
16384;10;56;577495888;578257687;761799
16384;10;57;578335672;579091384;755712
16384;10;58;579168269;579931044;762775
16384;10;59;580008927;580770842;761915
16384;10;60;580848800;581601497;752697
16384;10;61;581678297;582443982;765685
16384;10;62;582521892;583285246;763354
16384;10;63;583363156;584153195;790039
16384;10;64;584231184;584998054;766870
16384;10;65;585075907;585839275;763368
16384;10;66;585917215;586669914;752699
16384;10;67;586746797;587508705;761908
16384;10;68;587586639;588351938;765299
16384;10;69;588429957;589182605;752648
16384;10;70;589259806;590021757;761951
16384;10;71;590099745;590861729;761984
16384;10;72;590939669;591695480;755811
16384;10;73;591772645;592586808;814163
16384;10;74;592664687;593427051;762364
16384;10;75;593504996;594261625;756629
16384;10;76;594338891;595101631;762740
16384;10;77;595179525;595941609;762084
16384;10;78;596019604;596772327;752723
16384;10;79;596849176;597626620;777444
16384;10;80;597705117;598469455;764338
16384;10;81;598547422;599300100;752678
16384;10;82;599433195;600246476;813281
16384;10;83;600324780;601087294;762514
16384;10;84;601165267;601917967;752700
16384;10;85;601994751;602756805;762054
16384;10;86;602834719;603600175;765456
16384;10;87;603678407;604431756;753349
16384;10;88;604509085;605271776;762691
16384;10;89;605349733;606111854;762121
16384;10;90;606189743;606945346;755603
16384;10;91;607022186;607786314;764128
16384;10;92;607864256;608626746;762490
16384;10;93;608704601;609457271;752670
16384;10;94;609534183;610344900;810717
16384;10;95;610422939;611184918;761979
16384;10;96;611262832;612015498;752666
16384;10;97;612092545;612857667;765122
16384;10;98;612935575;613697816;762241
16384;10;99;613775681;614528303;752622
16384;10;0;614634741;615387790;753049
16384;10;1;615465683;616242350;776667
16384;10;2;616320450;617072972;752522
16384;10;3;617161655;617914678;753023
16384;10;4;617992245;618753963;761718
16384;10;5;618832009;619587526;755517
16384;10;6;619674966;620428037;753071
16384;10;7;620505534;621267468;761934
16384;10;8;621345366;622097896;752530
16384;10;9;622183730;622940258;756528
16384;10;10;623017645;623819752;802107
16384;10;11;623897816;624650472;752656
16384;10;12;624736654;625493040;756386
16384;10;13;625570500;626332965;762465
16384;10;14;626410968;627163580;752612
16384;10;15;627249513;628002730;753217
16384;10;16;628080137;628848827;768690
16384;10;17;628926741;629679387;752646
16384;10;18;629765528;630518739;753211
16384;10;19;630596143;631358027;761884
16384;10;20;631435989;632191638;755649
16384;10;21;632279689;633032882;753193
16384;10;22;633110276;633872081;761805
16384;10;23;633950023;634702705;752682
16384;10;24;634788608;635572663;784055
16384;10;25;635650695;636412876;762181
16384;10;26;636491133;637243825;752692
16384;10;27;637330218;638086675;756457
16384;10;28;638164153;638995201;831048
16384;10;29;639073510;639826168;752658
16384;10;30;639912157;640665257;753100
16384;10;31;640742758;641508194;765436
16384;10;32;641586227;642338887;752660
16384;10;33;642425045;643178201;753156
16384;10;34;643255742;644017766;762024
16384;10;35;644095753;644851637;755884
16384;10;36;644938424;645691629;753205
16384;10;37;645769101;646533361;764260
16384;10;38;646611341;647366918;755577
16384;10;39;647453814;648207046;753232
16384;10;40;648284453;649047580;763127
16384;10;41;649125470;649878142;752672
16384;10;42;649964450;650733288;768838
16384;10;43;650811327;651574262;762935
16384;10;44;651652154;652404887;752733
16384;10;45;652491455;653244662;753207
16384;10;46;653322005;654087781;765776
16384;10;47;654165742;654918428;752686
16384;10;48;655004602;655757756;753154
16384;10;49;655835113;656596934;761821
16384;10;50;656677821;657457748;779927
16384;10;51;657545341;658298524;753183
16384;10;52;658375964;659137763;761799
16384;10;53;659215834;659974499;758665
16384;10;54;660061349;660814556;753207
16384;10;55;660891967;661654032;762065
16384;10;56;661731992;662529146;797154
16384;10;57;662616364;663376023;759659
16384;10;58;663453520;664216983;763463
16384;10;59;664294891;665047565;752674
16384;10;60;665133541;665886733;753192
16384;10;61;665964165;666730454;766289
16384;10;62;666808394;667561105;752711
16384;10;63;667647311;668400491;753180
16384;10;64;668477941;669239846;761905
16384;10;65;669321459;670074859;753400
16384;10;66;670161731;670914855;753124
16384;10;67;670992295;671754114;761819
16384;10;68;671832139;672588167;756028
16384;10;69;672675287;673428433;753146
16384;10;70;673505925;674267779;761854
16384;10;71;674345784;675098448;752664
16384;10;72;675184484;675940887;756403
16384;10;73;676018331;676781521;763190
16384;10;74;676859489;677612125;752636
16384;10;75;677698066;678451257;753191
16384;10;76;678528756;679294434;765678
16384;10;77;679372435;680125055;752620
16384;10;78;680210982;680964205;753223
16384;10;79;681041667;681806860;765193
16384;10;80;681884762;682637454;752692
16384;10;81;682724813;683477997;753184
16384;10;82;683555431;684317275;761844
16384;10;83;684395247;685150984;755737
16384;10;84;685237601;686018959;781358
16384;10;85;686097029;686859251;762222
16384;10;86;686937151;687715889;778738
16384;10;87;687806876;688560049;753173
16384;10;88;688662599;689425756;763157
16384;10;89;689503792;690263124;759332
16384;10;90;690350029;691103183;753154
16384;10;91;691180636;691942866;762230
16384;10;92;692020802;692816870;796068
16384;10;93;692904131;693663521;759390
16384;10;94;693740934;694505185;764251
16384;10;95;694583247;695335946;752699
16384;10;96;695428502;696181574;753072
16384;10;97;696258965;697025652;766687
16384;10;98;697103609;697856285;752676
16384;10;99;697942546;698695656;753110
16384;10;0;699248232;699933131;684899
16384;10;1;700003557;700694902;691345
16384;10;2;700765702;701446673;680971
16384;10;3;701516335;702206439;690104
16384;10;4;702277135;702998975;721840
16384;10;5;703069739;703750722;680983
16384;10;6;703820374;704510579;690205
16384;10;7;704581264;705262228;680964
16384;10;8;705331899;706024971;693072
16384;10;9;706095631;706787363;691732
16384;10;10;706858030;707538962;680932
16384;10;11;707608683;708298560;689877
16384;10;12;708369320;709053419;684099
16384;10;13;709123393;709814256;690863
16384;10;14;709884870;710574852;689982
16384;10;15;710645448;711326437;680989
16384;10;16;711396140;712098080;701940
16384;10;17;712168888;712851303;682415
16384;10;18;712921066;713612521;691455
16384;10;19;713683242;714373163;689921
16384;10;20;714443809;715124754;680945
16384;10;21;715197304;715887784;690480
16384;10;22;715958558;716673174;714616
16384;10;23;716743916;717434763;690847
16384;10;24;717505514;718195468;689954
16384;10;25;718268998;718950259;681261
16384;10;26;719019912;719712193;692281
16384;10;27;719782797;720463758;680961
16384;10;28;720533440;721223657;690217
16384;10;29;721294360;721991772;697412
16384;10;30;722062526;722743489;680963
16384;10;31;722813809;723504196;690387
16384;10;32;723574885;724255833;680948
16384;10;33;724325540;725018714;693174
16384;10;34;725089411;725780098;690687
16384;10;35;725850756;726531709;680953
16384;10;36;726601306;727291543;690237
16384;10;37;727362169;728046283;684114
16384;10;38;728117346;728808347;691001
16384;10;39;728879089;729569510;690421
16384;10;40;729640132;730321105;680973
16384;10;41;730390773;731084391;693618
16384;10;42;731154948;731835917;680969
16384;10;43;731915179;732596574;681395
16384;10;44;732666888;733357091;690203
16384;10;45;733427791;734108750;680959
16384;10;46;734181499;734872214;690715
16384;10;47;734942818;735623789;680971
16384;10;48;735702634;736384006;681372
16384;10;49;736454261;737144398;690137
16384;10;50;737215060;737899149;684089
16384;10;51;737968965;738660918;691953
16384;10;52;738731501;739440411;708910
16384;10;53;739520484;740205663;685179
16384;10;54;740275898;740967263;691365
16384;10;55;741037962;741718915;680953
16384;10;56;741788569;742478395;689826
16384;10;57;742549017;743238906;689889
16384;10;58;743309476;743993593;684117
16384;10;59;744063486;744756915;693429
16384;10;60;744827616;745508567;680951
16384;10;61;745578184;746268333;690149
16384;10;62;746338971;747068489;729518
16384;10;63;747140705;747821878;681173
16384;10;64;747891765;748582902;691137
16384;10;65;748653580;749334553;680973
16384;10;66;749404262;750107919;703657
16384;10;67;750178697;750869171;690474
16384;10;68;751101514;752072293;970779
16384;10;69;752147473;752864203;716730
16384;10;70;752937294;753633764;696470
16384;10;71;753706144;754413541;707397
16384;10;72;754486255;755192700;706445
16384;10;73;755264962;756008550;743588
16384;10;74;756081061;756788017;706956
16384;10;75;756860352;757556784;696432
16384;10;76;757628147;758333894;705747
16384;10;77;758406241;759114811;708570
16384;10;78;759187158;759883983;696825
16384;10;79;759955267;760662209;706942
16384;10;80;760736802;761417761;680959
16384;10;81;761487459;762177389;689930
16384;10;82;762251451;762943049;691598
16384;10;83;763013817;763694768;680951
16384;10;84;763764529;764455016;690487
16384;10;85;764525712;765206683;680971
16384;10;86;765279195;765969801;690606
16384;10;87;766040542;766730569;690027
16384;10;88;766801335;767482267;680932
16384;10;89;767551998;768242071;690073
16384;10;90;768312807;768996898;684091
16384;10;91;769067386;769757936;690550
16384;10;92;769828675;770518720;690045
16384;10;93;770623597;771305014;681417
16384;10;94;771374755;772068959;694204
16384;10;95;772139753;772820736;680983
16384;10;96;772899405;773580796;681391
16384;10;97;773650938;774340887;689949
16384;10;98;774411671;775095737;684066
16384;10;99;775166067;775856622;690555
32768;10;0;776099029;777614162;1515133
32768;10;1;777771007;779339559;1568552
32768;10;2;779493091;781011353;1518262
32768;10;3;781164799;782680591;1515792
32768;10;4;782834005;784364806;1530801
32768;10;5;784518189;786033132;1514943
32768;10;6;786186352;787732065;1545713
32768;10;7;787885359;789409056;1523697
32768;10;8;789562337;791114266;1551929
32768;10;9;791267609;792782988;1515379
32768;10;10;792936282;794471206;1534924
32768;10;11;794624496;796139545;1515049
32768;10;12;796292835;797879380;1586545
32768;10;13;798032638;799560254;1527616
32768;10;14;799713585;801228285;1514700
32768;10;15;801381597;802900406;1518809
32768;10;16;803053662;804578880;1525218
32768;10;17;804732142;806250175;1518033
32768;10;18;806403413;807917973;1514560
32768;10;19;808071246;809598535;1527289
32768;10;20;809751882;811299096;1547214
32768;10;21;811452406;812970751;1518345
32768;10;22;813124001;814647905;1523904
32768;10;23;814801258;816322568;1521310
32768;10;24;816475755;817990333;1514578
32768;10;25;818143478;819671383;1527905
32768;10;26;819824680;821339169;1514489
32768;10;27;821492407;823010786;1518379
32768;10;28;823164330;824691433;1527103
32768;10;29;824844671;826359249;1514578
32768;10;30;826512477;828030397;1517920
32768;10;31;828183568;829707640;1524072
32768;10;32;829861033;831379654;1518621
32768;10;33;831532922;833047436;1514514
32768;10;34;833200597;834728018;1527421
32768;10;35;834881355;836395882;1514527
32768;10;36;836549232;838067243;1518011
32768;10;37;838220578;839744151;1523573
32768;10;38;839897583;841416044;1518461
32768;10;39;841569253;843110855;1541602
32768;10;40;843276837;844804422;1527585
32768;10;41;844958619;846480652;1522033
32768;10;42;846633792;848962755;2328963
32768;10;43;849124303;850678205;1553902
32768;10;44;850835704;852400215;1564511
32768;10;45;852557480;854107239;1549759
32768;10;46;854264373;855817204;1552831
32768;10;47;855973965;857533898;1559933
32768;10;48;857690685;859225998;1535313
32768;10;49;859379203;860893855;1514652
32768;10;50;861047182;862575139;1527957
32768;10;51;862728499;864243237;1514738
32768;10;52;864396448;865914656;1518208
32768;10;53;866067902;867594983;1527081
32768;10;54;867748320;869264540;1516220
32768;10;55;869417839;870935451;1517612
32768;10;56;871088778;872654789;1566011
32768;10;57;872808064;874325297;1517233
32768;10;58;874478620;875994134;1515514
32768;10;59;876147380;877677788;1530408
32768;10;60;877831009;879345798;1514789
32768;10;61;879499010;881071143;1572133
32768;10;62;881224356;882748408;1524052
32768;10;63;882901617;884421216;1519599
32768;10;64;884574516;886089190;1514674
32768;10;65;886242483;887770165;1527682
32768;10;66;887923401;889437937;1514536
32768;10;67;889627013;891142134;1515121
32768;10;68;891295461;892823716;1528255
32768;10;69;892976946;894498983;1522037
32768;10;70;894686139;896206163;1520024
32768;10;71;896359549;897885765;1526216
32768;10;72;898038995;899558117;1519122
32768;10;73;899711331;901226174;1514843
32768;10;74;901379455;902907315;1527860
32768;10;75;903060648;904606645;1545997
32768;10;76;904759927;906298488;1538561
32768;10;77;906463061;908116834;1653773
32768;10;78;908283389;909947019;1663630
32768;10;79;910116074;911796924;1680850
32768;10;80;911977057;913631102;1654045
32768;10;81;913798085;915482829;1684744
32768;10;82;915651989;917271776;1619787
32768;10;83;917428007;919003506;1575499
32768;10;84;919158523;920675010;1516487
32768;10;85;920831388;922355948;1524560
32768;10;86;922509331;924027245;1517914
32768;10;87;924180467;925696353;1515886
32768;10;88;925849508;927376873;1527365
32768;10;89;927530208;929044729;1514521
32768;10;90;929197990;930715525;1517535
32768;10;91;930868768;932394073;1525305
32768;10;92;932547344;934065448;1518104
32768;10;93;934218493;935733061;1514568
32768;10;94;935886228;937460492;1574264
32768;10;95;937613841;939128456;1514615
32768;10;96;939340801;940937158;1596357
32768;10;97;941094069;942688787;1594718
32768;10;98;942854168;944371821;1517653
32768;10;99;944525698;946675189;2149491
32768;10;0;946849169;948408796;1559627
32768;10;1;948566242;950119344;1553102
32768;10;2;950276140;951824949;1548809
32768;10;3;951984715;953528834;1544119
32768;10;4;953682315;955199868;1517553
32768;10;5;955353211;956869430;1516219
32768;10;6;957123588;958652153;1528565
32768;10;7;958805486;960320670;1515184
32768;10;8;960473869;961991611;1517742
32768;10;9;962144869;963660869;1516000
32768;10;10;963823300;965407762;1584462
32768;10;11;965561303;967076117;1514814
32768;10;12;967229413;968748076;1518663
32768;10;13;968910969;970425941;1514972
32768;10;14;970585391;972100917;1515526
32768;10;15;972254190;973827744;1573554
32768;10;16;973991040;975505969;1514929
32768;10;17;975659292;977177214;1517922
32768;10;18;977330526;978845514;1514988
32768;10;19;979008006;980526845;1518839
32768;10;20;980680014;982195024;1515010
32768;10;21;982348300;983924226;1575926
32768;10;22;984086805;985601862;1515057
32768;10;23;985755162;987273554;1518392
32768;10;24;987426808;988941372;1514564
32768;10;25;989103729;990622869;1519140
32768;10;26;990775996;992290619;1514623
32768;10;27;992447378;993962939;1515561
32768;10;28;994127551;995646609;1519058
32768;10;29;995800003;997354350;1554347
32768;10;30;997507588;999056934;1549346
32768;10;31;999219689;1000735357;1515668
32768;10;32;1000888623;1002410279;1521656
32768;10;33;1002563640;1004123601;1559961
32768;10;34;1004289197;1005804523;1515326
32768;10;35;1005957846;1007472402;1514556
32768;10;36;1007629040;1009144781;1515741
32768;10;37;1009307307;1010825612;1518305
32768;10;38;1010978890;1012494344;1515454
32768;10;39;1012647610;1014166015;1518405
32768;10;40;1014329178;1015844384;1515206
32768;10;41;1015997677;1017515781;1518104
32768;10;42;1017669154;1019185264;1516110
32768;10;43;1019347993;1020867111;1519118
32768;10;44;1021020391;1022535183;1514792
32768;10;45;1022688509;1024206484;1517975
32768;10;46;1024370523;1025885519;1514996
32768;10;47;1026038787;1027598027;1559240
32768;10;48;1027751495;1029266335;1514840
32768;10;49;1029460705;1030976132;1515427
32768;10;50;1031129392;1032650758;1521366
32768;10;51;1032804063;1034319111;1515048
32768;10;52;1034481628;1035999839;1518211
32768;10;53;1036153060;1037668832;1515772
32768;10;54;1037822078;1039340127;1518049
32768;10;55;1039503103;1041018512;1515409
32768;10;56;1041171855;1042689655;1517800
32768;10;57;1042842927;1044365397;1522470
32768;10;58;1044528197;1046047063;1518866
32768;10;59;1046200307;1047715195;1514888
32768;10;60;1047868570;1049386674;1518104
32768;10;61;1049550622;1051092741;1542119
32768;10;62;1051249352;1052765980;1516628
32768;10;63;1052919277;1054433748;1514471
32768;10;64;1054600100;1056115563;1515463
32768;10;65;1056268843;1057788217;1519374
32768;10;66;1057941445;1059456896;1515451
32768;10;67;1059619303;1061138323;1519020
32768;10;68;1061291686;1062806813;1515127
32768;10;69;1062960094;1064481251;1521157
32768;10;70;1064644246;1066159591;1515345
32768;10;71;1066312854;1067878055;1565201
32768;10;72;1068031427;1069546066;1514639
32768;10;73;1069708773;1071227739;1518966
32768;10;74;1071381048;1072895584;1514536
32768;10;75;1073048901;1074567181;1518280
32768;10;76;1074729549;1076244543;1514994
32768;10;77;1076426329;1077941629;1515300
32768;10;78;1078095047;1079612873;1517826
32768;10;79;1079775831;1081290877;1515046
32768;10;80;1081444115;1082962031;1517916
32768;10;81;1083115200;1084631838;1516638
32768;10;82;1084794411;1086313783;1519372
32768;10;83;1086467089;1087982008;1514919
32768;10;84;1088135317;1089653771;1518454
32768;10;85;1089844654;1091359969;1515315
32768;10;86;1091513306;1093035262;1521956
32768;10;87;1093188591;1094703364;1514773
32768;10;88;1094865842;1096387848;1522006
32768;10;89;1096541019;1098106362;1565343
32768;10;90;1098259673;1099774802;1515129
32768;10;91;1099937189;1101455406;1518217
32768;10;92;1101608666;1103152243;1543577
32768;10;93;1103305641;1104823720;1518079
32768;10;94;1104986731;1106506477;1519746
32768;10;95;1106708331;1108086846;1378515
32768;10;96;1108226674;1109604014;1377340
32768;10;97;1109744877;1111129400;1384523
32768;10;98;1111269301;1112666989;1397688
32768;10;99;1112807008;1114188703;1381695
32768;10;0;1115311489;1116687734;1376245
32768;10;1;1116827001;1118198799;1371798
32768;10;2;1118337971;1119712318;1374347
32768;10;3;1119851614;1121297397;1445783
32768;10;4;1121436409;1122817312;1380903
32768;10;5;1122959371;1124341902;1382531
32768;10;6;1124481056;1125852600;1371544
32768;10;7;1125991335;1127369246;1377911
32768;10;8;1127508184;1128879544;1371360
32768;10;9;1129018443;1130402091;1383648
32768;10;10;1130540951;1131911797;1370846
32768;10;11;1132050761;1133425985;1375224
32768;10;12;1133564851;1134936299;1371448
32768;10;13;1135075491;1136449626;1374135
32768;10;14;1136598206;1138096829;1498623
32768;10;15;1138244130;1139623517;1379387
32768;10;16;1139762876;1141134837;1371961
32768;10;17;1141273912;1142649057;1375145
32768;10;18;1142787960;1144160550;1372590
32768;10;19;1144308567;1145683510;1374943
32768;10;20;1145822502;1147193479;1370977
32768;10;21;1147332384;1148706885;1374501
32768;10;22;1148845778;1150217381;1371603
32768;10;23;1150356278;1151730751;1374473
32768;10;24;1151879202;1153250507;1371305
32768;10;25;1153389453;1154763869;1374416
32768;10;26;1154902883;1156273867;1370984
32768;10;27;1156412877;1157790349;1377472
32768;10;28;1157929361;1159300774;1371413
32768;10;29;1159448723;1160833128;1384405
32768;10;30;1160971994;1162342958;1370964
32768;10;31;1162481938;1163852972;1371034
32768;10;32;1163995111;1165366678;1371567
32768;10;33;1165505645;1166885543;1379898
32768;10;34;1167027403;1168399589;1372186
32768;10;35;1168538484;1169909314;1370830
32768;10;36;1170048287;1171438081;1389794
32768;10;37;1171577053;1172948077;1371024
32768;10;38;1173087002;1174472137;1385135
32768;10;39;1174611198;1175982137;1370939
32768;10;40;1176121048;1177495946;1374898
32768;10;41;1177634962;1179005873;1370911
32768;10;42;1179144778;1180519143;1374365
32768;10;43;1180658172;1182038059;1379887
32768;10;44;1182177015;1183551893;1374878
32768;10;45;1183690846;1185061763;1370917
32768;10;46;1185200767;1186577044;1376277
32768;10;47;1186715890;1188087334;1371444
32768;10;48;1188235118;1189619985;1384867
32768;10;49;1189758925;1191129896;1370971
32768;10;50;1191268827;1192644137;1375310
32768;10;51;1192783102;1194155323;1372221
32768;10;52;1194294214;1195669021;1374807
32768;10;53;1195817617;1197189891;1372274
32768;10;54;1197330667;1198707651;1376984
32768;10;55;1198847862;1200223799;1375937
32768;10;56;1200364234;1201744163;1379929
32768;10;57;1201884679;1203258219;1373540
32768;10;58;1203407406;1204784824;1377418
32768;10;59;1204924786;1206298062;1373276
32768;10;60;1206438953;1207816492;1377539
32768;10;61;1207956397;1209327899;1371502
32768;10;62;1209466763;1210850711;1383948
32768;10;63;1210989675;1212360703;1371028
32768;10;64;1212499829;1213870756;1370927
32768;10;65;1214012872;1215384633;1371761
32768;10;66;1215523542;1216894443;1370901
32768;10;67;1217033309;1218429565;1396256
32768;10;68;1218569029;1219940203;1371174
32768;10;69;1220079171;1221454010;1374839
32768;10;70;1221592933;1222963779;1370846
32768;10;71;1223102698;1224477434;1374736
32768;10;72;1224616321;1225996231;1379910
32768;10;73;1226135219;1227509811;1374592
32768;10;74;1227648700;1229019625;1370925
32768;10;75;1229158625;1230534426;1375801
32768;10;76;1230674064;1232046080;1372016
32768;10;77;1232185050;1233658165;1473115
32768;10;78;1233855999;1235299028;1443029
32768;10;79;1235442987;1236849107;1406120
32768;10;80;1236991294;1238393368;1402074
32768;10;81;1238535462;1239941391;1405929
32768;10;82;1240083554;1241494789;1411235
32768;10;83;1241636906;1243042681;1405775
32768;10;84;1243184826;1244563132;1378306
32768;10;85;1244702187;1246076943;1374756
32768;10;86;1246215882;1247586752;1370870
32768;10;87;1247725807;1249110362;1384555
32768;10;88;1249249334;1250620198;1370864
32768;10;89;1250759164;1252137235;1378071
32768;10;90;1252276286;1253647480;1371194
32768;10;91;1253786468;1255170384;1383916
32768;10;92;1255318881;1256690154;1371273
32768;10;93;1256913350;1258291486;1378136
32768;10;94;1258430427;1259801960;1371533
32768;10;95;1259940822;1261315050;1374228
32768;10;96;1261453995;1262825380;1371385
32768;10;97;1262973328;1264358997;1385669
32768;10;98;1264497900;1265870182;1372282
32768;10;99;1266009105;1267383400;1374295
65536;10;0;1267866627;1270912632;3046005
65536;10;1;1271216816;1274249719;3032903
65536;10;2;1274563657;1277600422;3036765
65536;10;3;1277904281;1280954020;3049739
65536;10;4;1281257885;1284298403;3040518
65536;10;5;1284621032;1287658392;3037360
65536;10;6;1287962343;1291007600;3045257
65536;10;7;1291311802;1294345791;3033989
65536;10;8;1294659062;1297693049;3033987
65536;10;9;1297996906;1301039333;3042427
65536;10;10;1301343174;1304377772;3034598
65536;10;11;1304691048;1307724787;3033739
65536;10;12;1308028635;1311085558;3056923
65536;10;13;1311440478;1314496284;3055806
65536;10;14;1314810459;1317843504;3033045
65536;10;15;1318147373;1321196146;3048773
65536;10;16;1321500034;1324533158;3033124
65536;10;17;1324847661;1327898202;3050541
65536;10;18;1328203780;1331272553;3068773
65536;10;19;1331576428;1335065439;3489011
65536;10;20;1335382179;1338854603;3472424
65536;10;21;1339166031;1342236778;3070747
65536;10;22;1342544122;1345684085;3139963
65536;10;23;1345988155;1349030177;3042022
65536;10;24;1349305719;1352052412;2746693
65536;10;25;1352331941;1355081258;2749317
65536;10;26;1355381162;1358126315;2745153
65536;10;27;1358405275;1361197922;2792647
65536;10;28;1361476572;1364229764;2753192
65536;10;29;1364511519;1367255541;2744022
65536;10;30;1367530864;1370336221;2805357
65536;10;31;1370620899;1373368136;2747237
65536;10;32;1373647632;1376396207;2748575
65536;10;33;1376719806;1379479579;2759773
65536;10;34;1379755107;1382501689;2746582
65536;10;35;1382781184;1385531709;2750525
65536;10;36;1385816157;1388562737;2746580
65536;10;37;1388838079;1391590942;2752863
65536;10;38;1391875801;1394624340;2748539
65536;10;39;1394899766;1397647359;2747593
65536;10;40;1397922721;1400678264;2755543
65536;10;41;1400983869;1403772907;2789038
65536;10;42;1404048386;1406799100;2750714
65536;10;43;1407084566;1409862530;2777964
65536;10;44;1410137806;1412912732;2774926
65536;10;45;1413188056;1415944666;2756610
65536;10;46;1416219932;1418966984;2747052
65536;10;47;1419242218;1421988390;2746172
65536;10;48;1422273119;1425020961;2747842
65536;10;49;1425296179;1428043063;2746884
65536;10;50;1428318297;1431074544;2756247
65536;10;51;1431349795;1434124861;2775066
65536;10;52;1434400167;1437149883;2749716
65536;10;53;1437434725;1440180113;2745388
65536;10;54;1440458374;1443203092;2744718
65536;10;55;1443481491;1446235331;2753840
65536;10;56;1446510635;1449257293;2746658
65536;10;57;1449532575;1452308729;2776154
65536;10;58;1452593019;1455339925;2746906
65536;10;59;1455615189;1458362580;2747391
65536;10;60;1458646884;1461393612;2746728
65536;10;61;1461668937;1464415422;2746485
65536;10;62;1464715470;1467478715;2763245
65536;10;63;1467754034;1470499814;2745780
65536;10;64;1470799210;1473552481;2753271
65536;10;65;1473836799;1476584777;2747978
65536;10;66;1476860058;1479607582;2747524
65536;10;67;1479882862;1482639221;2756359
65536;10;68;1482914455;1485660697;2746242
65536;10;69;1485935998;1488682765;2746767
65536;10;70;1488994052;1491741754;2747702
65536;10;71;1492017108;1494794490;2777382
65536;10;72;1495069730;1497853881;2784151
65536;10;73;1498129258;1500879395;2750137
65536;10;74;1501154695;1503926811;2772116
65536;10;75;1504211117;1506958392;2747275
65536;10;76;1507233658;1509980468;2746810
65536;10;77;1510255728;1513012340;2756612
65536;10;78;1513287627;1516034975;2747348
65536;10;79;1516310296;1519094816;2784520
65536;10;80;1519370960;1522119555;2748595
65536;10;81;1522396113;1525145051;2748938
65536;10;82;1525429822;1528533001;3103179
65536;10;83;1528812048;1531613865;2801817
65536;10;84;1531889516;1534646932;2757416
65536;10;85;1534922255;1537675005;2752750
65536;10;86;1537950266;1540731370;2781104
65536;10;87;1541018661;1543803721;2785060
65536;10;88;1544081348;1546847719;2766371
65536;10;89;1547123854;1549881841;2757987
65536;10;90;1550157120;1552904204;2747084
65536;10;91;1553245123;1555993186;2748063
65536;10;92;1556278047;1559025127;2747080
65536;10;93;1559300406;1562051220;2750814
65536;10;94;1562327926;1565146611;2818685
65536;10;95;1565421928;1568168304;2746376
65536;10;96;1568526518;1571287750;2761232
65536;10;97;1571565337;1574308483;2743146
65536;10;98;1574586898;1577331044;2744146
65536;10;99;1577621504;1580364745;2743241
65536;10;0;1580674412;1583418704;2744292
65536;10;1;1583694481;1586450480;2755999
65536;10;2;1586725791;1589516235;2790444
65536;10;3;1589791590;1592577668;2786078
65536;10;4;1592862102;1595674598;2812496
65536;10;5;1595978242;1598728800;2750558
65536;10;6;1599004192;1601761096;2756904
65536;10;7;1602036660;1604783013;2746353
65536;10;8;1605058332;1607805915;2747583
65536;10;9;1608090138;1610836988;2746850
65536;10;10;1611112214;1613859873;2747659
65536;10;11;1614135164;1616890804;2755640
65536;10;12;1617166131;1620031215;2865084
65536;10;13;1620352036;1623150626;2798590
65536;10;14;1623440977;1626477387;3036410
65536;10;15;1626757787;1629521722;2763935
65536;10;16;1629800183;1632569816;2769633
65536;10;17;1632846591;1635612399;2765808
65536;10;18;1635912322;1638793723;2881401
65536;10;19;1639070018;1641816537;2746519
65536;10;20;1642091820;1644838670;2746850
65536;10;21;1645122939;1647870506;2747567
65536;10;22;1648145821;1650892326;2746505
65536;10;23;1651167611;1653925760;2758149
65536;10;24;1654201271;1657055124;2853853
65536;10;25;1657330512;1660077447;2746935
65536;10;26;1660362522;1663110263;2747741
65536;10;27;1663385570;1666131806;2746236
65536;10;28;1666407107;1669166232;2759125
65536;10;29;1669441486;1672370373;2928887
65536;10;30;1672647213;1675493114;2845901
65536;10;31;1675778021;1678533133;2755112
65536;10;32;1678809112;1681557256;2748144
65536;10;33;1681832809;1684827681;2994872
65536;10;34;1685103956;1687951527;2847571
65536;10;35;1688226816;1691067921;2841105
65536;10;36;1691366469;1694115688;2749219
65536;10;37;1694391041;1697138511;2747470
65536;10;38;1697423361;1700167115;2743754
65536;10;39;1700445259;1703189818;2744559
65536;10;40;1703468231;1706221432;2753201
65536;10;41;1706499859;1709244495;2744636
65536;10;42;1709522963;1712309418;2786455
65536;10;43;1712598211;1715340810;2742599
65536;10;44;1715616113;1718366920;2750807
65536;10;45;1718643022;1721399363;2756341
65536;10;46;1721840621;1724650863;2810242
65536;10;47;1724933335;1727679945;2746610
65536;10;48;1727965161;1730748906;2783745
65536;10;49;1731024988;1733772330;2747342
65536;10;50;1734057875;1736812167;2754292
65536;10;51;1737087494;1739835923;2748429
65536;10;52;1740111151;1742867753;2756602
65536;10;53;1743143141;1745889827;2746686
65536;10;54;1746165132;1748912573;2747441
65536;10;55;1749197014;1751976084;2779070
65536;10;56;1752251431;1754998291;2746860
65536;10;57;1755273547;1758029706;2756159
65536;10;58;1758305039;1761052427;2747388
65536;10;59;1761327700;1764074187;2746487
65536;10;60;1764358542;1767105883;2747341
65536;10;61;1767381225;1770127696;2746471
65536;10;62;1770403005;1773159821;2756816
65536;10;63;1773435155;1776259386;2824231
65536;10;64;1776535057;1779325258;2790201
65536;10;65;1779609762;1782379497;2769735
65536;10;66;1782654828;1785401106;2746278
65536;10;67;1785676429;1788436622;2760193
65536;10;68;1788711894;1791458537;2746643
65536;10;69;1791733824;1794482033;2748209
65536;10;70;1794766701;1797513632;2746931
65536;10;71;1797788995;1800536677;2747682
65536;10;72;1800821463;1803567594;2746131
65536;10;73;1803842913;1806621978;2779065
65536;10;74;1806897241;1809649797;2752556
65536;10;75;1809931578;1812676714;2745136
65536;10;76;1812952062;1816730878;3778816
65536;10;77;1817120032;1819904820;2784788
65536;10;78;1820192224;1822979414;2787190
65536;10;79;1823254930;1826001852;2746922
65536;10;80;1826277179;1829155038;2877859
65536;10;81;1829430544;1832176907;2746363
65536;10;82;1832452141;1835200884;2748743
65536;10;83;1835485723;1838241072;2755349
65536;10;84;1838516383;1841267819;2751436
65536;10;85;1841543162;1844368803;2825641
65536;10;86;1844644235;1847387669;2743434
65536;10;87;1847666108;1850410190;2744082
65536;10;88;1850795047;1853539803;2744756
65536;10;89;1853818633;1856563423;2744790
65536;10;90;1856851006;1859595713;2744707
65536;10;91;1859871054;1862617694;2746640
65536;10;92;1862892998;1865648697;2755699
65536;10;93;1865924417;1868730604;2806187
65536;10;94;1869005991;1871784939;2778948
65536;10;95;1872069608;1874821147;2751539
65536;10;96;1875142161;1877936999;2794838
65536;10;97;1878212615;1881035723;2823108
65536;10;98;1881311125;1884057594;2746469
65536;10;99;1884332951;1887081575;2748624
65536;10;0;1889261520;1892008116;2746596
65536;10;1;1892293787;1895040519;2746732
65536;10;2;1895315820;1898061040;2745220
65536;10;3;1898336150;1901125280;2789130
65536;10;4;1901400568;1904148668;2748100
65536;10;5;1904423762;1907201199;2777437
65536;10;6;1907486341;1910228586;2742245
65536;10;7;1910506532;1913265681;2759149
65536;10;8;1913540844;1916586056;3045212
65536;10;9;1916863884;1919610950;2747066
65536;10;10;1919886563;1922629547;2742984
65536;10;11;1922917975;1925661719;2743744
65536;10;12;1925941017;1928684732;2743715
65536;10;13;1928972353;1931787060;2814707
65536;10;14;1932065848;1934815812;2749964
65536;10;15;1935090892;1937848039;2757147
65536;10;16;1938123119;1940868720;2745601
65536;10;17;1941143834;1943890629;2746795
65536;10;18;1944175508;1946921459;2745951
65536;10;19;1947196648;1949943135;2746487
65536;10;20;1950218272;1952973246;2754974
65536;10;21;1953248336;1955991367;2743031
65536;10;22;1956269681;1959012347;2742666
65536;10;23;1959300669;1962770648;3469979
65536;10;24;1963046283;1965795990;2749707
65536;10;25;1966071967;1968862338;2790371
65536;10;26;1969137572;1971882593;2745021
65536;10;27;1972157713;1974903966;2746253
65536;10;28;1975188717;1977934585;2745868
65536;10;29;1978209728;1980956209;2746481
65536;10;30;1981231325;1984013208;2781883
65536;10;31;1984288523;1987038124;2749601
65536;10;32;1987316521;1990059509;2742988
65536;10;33;1990347116;1993123267;2776151
65536;10;34;1993402456;1996145969;2743513
65536;10;35;1996430042;1999179937;2749895
65536;10;36;1999476752;2002229769;2753017
65536;10;37;2002505022;2005259803;2754781
65536;10;38;2005535003;2008281265;2746262
65536;10;39;2008556394;2011311390;2754996
65536;10;40;2011595581;2014659592;3064011
65536;10;41;2014937353;2017684681;2747328
65536;10;42;2017960698;2020715786;2755088
65536;10;43;2020991423;2023775202;2783779
65536;10;44;2024050787;2026797946;2747159
65536;10;45;2027082366;2029832259;2749893
65536;10;46;2030107503;2032853304;2745801
65536;10;47;2033128477;2035917787;2789310
65536;10;48;2036193732;2038940952;2747220
65536;10;49;2039216255;2041962740;2746485
65536;10;50;2042248348;2044994540;2746192
65536;10;51;2045269727;2048015755;2746028
65536;10;52;2048300174;2051046353;2746179
65536;10;53;2051321506;2054067544;2746038
65536;10;54;2054342719;2057134670;2791951
65536;10;55;2057409977;2060159599;2749622
65536;10;56;2060434992;2063215961;2780969
65536;10;57;2063501665;2066247362;2745697
65536;10;58;2066522473;2069267972;2745499
65536;10;59;2069543094;2072298111;2755017
65536;10;60;2072573304;2075318489;2745185
65536;10;61;2075593685;2078339490;2745805
65536;10;62;2078624152;2081366417;2742265
65536;10;63;2081644838;2084398000;2753162
65536;10;64;2084673175;2087490209;2817034
65536;10;65;2087765518;2090518032;2752514
65536;10;66;2090793165;2093572319;2779154
65536;10;67;2093858942;2096604832;2745890
65536;10;68;2096880175;2099626235;2746060
65536;10;69;2099901351;2102689833;2788482
65536;10;70;2102965124;2105710789;2745665
65536;10;71;2105985966;2108732557;2746591
65536;10;72;2109017241;2111930469;2913228
65536;10;73;2112208194;2114955770;2747576
65536;10;74;2115241621;2118025608;2783987
65536;10;75;2118301577;2121050607;2749030
65536;10;76;2121326425;2124078161;2751736
65536;10;77;2124356296;2127099776;2743480
65536;10;78;2127378499;2130121423;2742924
65536;10;79;2130408572;2133153077;2744505
65536;10;80;2133428211;2136173791;2745580
65536;10;81;2136448942;2139239927;2790985
65536;10;82;2139518601;2142262197;2743596
65536;10;83;2142537402;2145283758;2746356
65536;10;84;2145568127;2148314270;2746143
65536;10;85;2148589483;2151373140;2783657
65536;10;86;2151729070;2154488683;2759613
65536;10;87;2154763800;2157548383;2784583
65536;10;88;2157909781;2160660261;2750480
65536;10;89;2160944936;2163902442;2957506
65536;10;90;2164177871;2166925652;2747781
65536;10;91;2167209877;2169955888;2746011
65536;10;92;2170231021;2172977454;2746433
65536;10;93;2173252702;2176007583;2754881
65536;10;94;2176282782;2179064895;2782113
65536;10;95;2179340105;2182086592;2746487
65536;10;96;2182377242;2185127944;2750702
65536;10;97;2185403139;2188178233;2775094
65536;10;98;2188453453;2191240497;2787044
65536;10;99;2191515733;2194261358;2745625
131072;10;0;2195098944;2200630928;5531984
131072;10;1;2201179649;2206695164;5515515
131072;10;2;2207243248;2212780420;5537172
131072;10;3;2213328944;2218819665;5490721
131072;10;4;2219380827;2224871616;5490789
131072;10;5;2225431830;2231130946;5699116
131072;10;6;2231682141;2237191662;5509521
131072;10;7;2237743486;2243285638;5542152
131072;10;8;2243850827;2249345766;5494939
131072;10;9;2249942959;2255435662;5492703
131072;10;10;2255992817;2261487488;5494671
131072;10;11;2262044636;2267538502;5493866
131072;10;12;2268086451;2273588473;5502022
131072;10;13;2274136387;2279723707;5587320
131072;10;14;2280271659;2285766620;5494961
131072;10;15;2286324291;2291855133;5530842
131072;10;16;2292412170;2297966174;5554004
131072;10;17;2298514196;2304099150;5584954
131072;10;18;2304648447;2310181331;5532884
131072;10;19;2310729233;2316223345;5494112
131072;10;20;2316781164;2322529465;5748301
131072;10;21;2323092712;2328629781;5537069
131072;10;22;2329188495;2334687000;5498505
131072;10;23;2335274572;2340775980;5501408
131072;10;24;2341327732;2346868079;5540347
131072;10;25;2347420283;2352946032;5525749
131072;10;26;2353506935;2358998334;5491399
131072;10;27;2359555367;2365049825;5494458
131072;10;28;2365597634;2371102635;5505001
131072;10;29;2371650489;2377184553;5534064
131072;10;30;2377732319;2383255845;5523526
131072;10;31;2383812927;2389308224;5495297
131072;10;32;2389865259;2395360937;5495678
131072;10;33;2395918057;2401489743;5571686
131072;10;34;2402037722;2407563990;5526268
131072;10;35;2408111963;2413615038;5503075
131072;10;36;2414163155;2419659788;5496633
131072;10;37;2420217204;2425711153;5493949
131072;10;38;2426268504;2431825484;5556980
131072;10;39;2432384724;2437886176;5501452
131072;10;40;2438437261;2443939018;5501757
131072;10;41;2444486827;2450018358;5531531
131072;10;42;2450575662;2456071269;5495607
131072;10;43;2456628180;2462130541;5502361
131072;10;44;2462687406;2468232216;5544810
131072;10;45;2468780132;2474283882;5503750
131072;10;46;2474831644;2480362796;5531152
131072;10;47;2480910721;2486405445;5494724
131072;10;48;2486962460;2492577517;5615057
131072;10;49;2493135085;2499692808;6557723
131072;10;50;2500356969;2506890875;6533906
131072;10;51;2507519192;2513453791;5934599
131072;10;52;2514019511;2519522799;5503288
131072;10;53;2520085377;2525751697;5666320
131072;10;54;2526313754;2531846153;5532399
131072;10;55;2532403790;2538130889;5727099
131072;10;56;2538682721;2544186941;5504220
131072;10;57;2544786446;2550315287;5528841
131072;10;58;2550878193;2556616696;5738503
131072;10;59;2557182743;2562793181;5610438
131072;10;60;2563341562;2568845625;5504063
131072;10;61;2569393383;2574958665;5565282
131072;10;62;2575506538;2581000485;5493947
131072;10;63;2581557121;2587159555;5602434
131072;10;64;2587717076;2593330495;5613419
131072;10;65;2593890029;2599391561;5501532
131072;10;66;2599939303;2605498524;5559221
131072;10;67;2606057726;2611609097;5551371
131072;10;68;2612157352;2617687224;5529872
131072;10;69;2618245522;2623740910;5495388
131072;10;70;2624298336;2629791392;5493056
131072;10;71;2630348500;2635838275;5489775
131072;10;72;2636389002;2641890178;5501176
131072;10;73;2642441129;2647947214;5506085
131072;10;74;2648498876;2654045509;5546633
131072;10;75;2654605639;2660131888;5526249
131072;10;76;2660688848;2666214289;5525441
131072;10;77;2666762157;2672266376;5504219
131072;10;78;2672814086;2678353557;5539471
131072;10;79;2678901396;2684418683;5517287
131072;10;80;2684975432;2690477959;5502527
131072;10;81;2691036290;2696743102;5706812
131072;10;82;2697381662;2702888473;5506811
131072;10;83;2703436871;2709032252;5595381
131072;10;84;2709580889;2715110040;5529151
131072;10;85;2715668762;2721162776;5494014
131072;10;86;2721720124;2727214012;5493888
131072;10;87;2727770903;2733265455;5494552
131072;10;88;2733813289;2739318348;5505059
131072;10;89;2739866421;2745414157;5547736
131072;10;90;2745962309;2751456678;5494369
131072;10;91;2752014007;2757539758;5525751
131072;10;92;2758097089;2763661532;5564443
131072;10;93;2764209497;2769713692;5504195
131072;10;94;2770261523;2775782214;5520691
131072;10;95;2776336264;2781827638;5491374
131072;10;96;2782384576;2787880495;5495919
131072;10;97;2788444968;2794181220;5736252
131072;10;98;2794788617;2800280078;5491461
131072;10;99;2800836891;2806379314;5542423
131072;10;0;2806989302;2812590037;5600735
131072;10;1;2813138832;2818633749;5494917
131072;10;2;2819191005;2824823481;5632476
131072;10;3;2825381515;2831158149;5776634
131072;10;4;2831756929;2837445252;5688323
131072;10;5;2837996669;2848099864;10103195
131072;10;6;2848648487;2854148707;5500220
131072;10;7;2854709626;2861026318;6316692
131072;10;8;2861583444;2870249802;8666358
131072;10;9;2870808259;2877840144;7031885
131072;10;10;2879137983;2889699367;10561384
131072;10;11;2890322732;2898917928;8595196
131072;10;12;2899470643;2910736229;11265586
131072;10;13;2911285117;2922006054;10720937
131072;10;14;2922564247;2929452032;6887785
131072;10;15;2930009587;2935504567;5494980
131072;10;16;2936061421;2941558122;5496701
131072;10;17;2942106002;2947657084;5551082
131072;10;18;2948204933;2953708241;5503308
131072;10;19;2954256164;2959749624;5493460
131072;10;20;2960306817;2965801766;5494949
131072;10;21;2966394437;2971930009;5535572
131072;10;22;2972478288;2977982455;5504167
131072;10;23;2978531003;2984038365;5507362
131072;10;24;2984586482;2990133785;5547303
131072;10;25;2990691191;2996216531;5525340
131072;10;26;2996774024;3002270246;5496222
131072;10;27;3002827069;3008320977;5493908
131072;10;28;3008868812;3014370249;5501437
131072;10;29;3014918200;3020479567;5561367
131072;10;30;3021028344;3026528580;5500236
131072;10;31;3027087478;3032587216;5499738
131072;10;32;3033144887;3038671697;5526810
131072;10;33;3039219842;3044722871;5503029
131072;10;34;3045270704;3050773301;5502597
131072;10;35;3051321074;3056842121;5521047
131072;10;36;3057399529;3062889721;5490192
131072;10;37;3063450154;3068947334;5497180
131072;10;38;3069506234;3075032963;5526729
131072;10;39;3075581092;3081515128;5934036
131072;10;40;3082298826;3088643870;6345044
131072;10;41;3089276103;3095333090;6056987
131072;10;42;3095884945;3101389027;5504082
131072;10;43;3101937008;3107438919;5501911
131072;10;44;3107986643;3113553795;5567152
131072;10;45;3114124359;3119631397;5507038
131072;10;46;3120188412;3125789843;5601431
131072;10;47;3126339220;3131888799;5549579
131072;10;48;3132436815;3137940109;5503294
131072;10;49;3138487977;3143981508;5493531
131072;10;50;3144538756;3150094460;5555704
131072;10;51;3150652395;3156340370;5687975
131072;10;52;3156900135;3162413082;5512947
131072;10;53;3162965433;3168627007;5661574
131072;10;54;3169178510;3175032747;5854237
131072;10;55;3175637817;3181442850;5805033
131072;10;56;3182006097;3187747292;5741195
131072;10;57;3188322117;3193959318;5637201
131072;10;58;3194507603;3200011251;5503648
131072;10;59;3200559115;3206133247;5574132
131072;10;60;3206681299;3212308906;5627607
131072;10;61;3212865935;3218356166;5490231
131072;10;62;3218917496;3224462355;5544859
131072;10;63;3225026710;3230883824;5857114
131072;10;64;3231433192;3236933840;5500648
131072;10;65;3237484787;3242984847;5500060
131072;10;66;3243536089;3249041936;5505847
131072;10;67;3249589962;3255217714;5627752
131072;10;68;3255774533;3261269056;5494523
131072;10;69;3261825931;3267319714;5493783
131072;10;70;3267867486;3273819587;5952101
131072;10;71;3274425062;3279937230;5512168
131072;10;72;3280485956;3285982241;5496285
131072;10;73;3286540022;3292190126;5650104
131072;10;74;3292748096;3298244074;5495978
131072;10;75;3298792288;3304298676;5506388
131072;10;76;3304846467;3310352886;5506419
131072;10;77;3310980372;3316601732;5621360
131072;10;78;3317208640;3322700420;5491780
131072;10;79;3323261122;3328751193;5490071
131072;10;80;3329311610;3334934354;5622744
131072;10;81;3335485948;3340986843;5500895
131072;10;82;3341537523;3347038685;5501162
131072;10;83;3347586401;3353090235;5503834
131072;10;84;3353647187;3359259365;5612178
131072;10;85;3359816293;3365344506;5528213
131072;10;86;3365892372;3371408632;5516260
131072;10;87;3371956747;3377593561;5636814
131072;10;88;3378141433;3383638891;5497458
131072;10;89;3384196851;3389691630;5494779
131072;10;90;3390248422;3395872412;5623990
131072;10;91;3396429427;3401931032;5501605
131072;10;92;3402478839;3407981315;5502476
131072;10;93;3408529093;3414059865;5530772
131072;10;94;3414617957;3420287697;5669740
131072;10;95;3420849050;3426354873;5505823
131072;10;96;3426914269;3432412041;5497772
131072;10;97;3432960127;3438620683;5660556
131072;10;98;3439168680;3444674787;5506107
131072;10;99;3445222663;3450715100;5492437
131072;10;0;3455169742;3461834270;6664528
131072;10;1;3462496255;3469404441;6908186
131072;10;2;3470057836;3476582388;6524552
131072;10;3;3477365392;3483888100;6522708
131072;10;4;3484547889;3491472421;6924532
131072;10;5;3492141882;3498784767;6642885
131072;10;6;3499433213;3506027240;6594027
131072;10;7;3506682921;3513207457;6524536
131072;10;8;3513868405;3520524434;6656029
131072;10;9;3521170109;3527677971;6507862
131072;10;10;3528320218;3534828902;6508684
131072;10;11;3535483591;3542137895;6654304
131072;10;12;3542794918;3549303997;6509079
131072;10;13;3549954018;3556525249;6571231
131072;10;14;3557168777;3563847719;6678942
131072;10;15;3564505946;3571236523;6730577
131072;10;16;3571886603;3578423422;6536819
131072;10;17;3579074537;3585695452;6620915
131072;10;18;3586355777;3592864939;6509162
131072;10;19;3593532684;3600277686;6745002
131072;10;20;3600928639;3607481152;6552513
131072;10;21;3608140014;3614650363;6510349
131072;10;22;3615317292;3621956334;6639042
131072;10;23;3622607896;3629102788;6494892
131072;10;24;3629750733;3636232369;6481636
131072;10;25;3636888639;3643523807;6635168
131072;10;26;3644181660;3650671723;6490063
131072;10;27;3651323473;3657804554;6481081
131072;10;28;3658464544;3665245469;6780925
131072;10;29;3665911354;3672419965;6508611
131072;10;30;3673071112;3679630804;6559692
131072;10;31;3680279084;3686956383;6677299
131072;10;32;3687619690;3694265672;6645982
131072;10;33;3694915024;3701436768;6521744
131072;10;34;3702100419;3708905392;6804973
131072;10;35;3709563564;3716059430;6495866
131072;10;36;3716715058;3723311568;6596510
131072;10;37;3723974003;3730514439;6540436
131072;10;38;3731170369;3737877217;6706848
131072;10;39;3738573643;3745562710;6989067
131072;10;40;3746274279;3755235768;8961489
131072;10;41;3755963468;3763022171;7058703
131072;10;42;3763716333;3770721010;7004677
131072;10;43;3771438948;3778432528;6993580
131072;10;44;3779140345;3786127002;6986657
131072;10;45;3786835138;3793851115;7015977
131072;10;46;3794546962;3801581463;7034501
131072;10;47;3802306002;3809310161;7004159
131072;10;48;3810018620;3816994656;6976036
131072;10;49;3817699400;3824704825;7005425
131072;10;50;3825418864;3832434870;7016006
131072;10;51;3833146262;3840126948;6980686
131072;10;52;3840820038;3847830465;7010427
131072;10;53;3848525544;3855527488;7001944
131072;10;54;3856236752;3863195691;6958939
131072;10;55;3863908001;3870885055;6977054
131072;10;56;3871580627;3878593872;7013245
131072;10;57;3879306172;3886268239;6962067
131072;10;58;3886979140;3893970489;6991349
131072;10;59;3894683544;3901685245;7001701
131072;10;60;3902392468;3909404820;7012352
131072;10;61;3910118558;3917172038;7053480
131072;10;62;3917879161;3924880575;7001414
131072;10;63;3925579914;3932570836;6990922
131072;10;64;3933272626;3940250331;6977705
131072;10;65;3940958738;3947938203;6979465
131072;10;66;3948634985;3955651306;7016321
131072;10;67;3956346578;3963344073;6997495
131072;10;68;3964051674;3971081430;7029756
131072;10;69;3971867715;3978908127;7040412
131072;10;70;3979618139;3986653177;7035038
131072;10;71;3987352436;3994363341;7010905
131072;10;72;3995076505;4002271808;7195303
131072;10;73;4003065389;4010048144;6982755
131072;10;74;4010743045;4017760095;7017050
131072;10;75;4018456466;4025518172;7061706
131072;10;76;4026234329;4033287931;7053602
131072;10;77;4034010015;4041039791;7029776
131072;10;78;4041737012;4048757649;7020637
131072;10;79;4049456017;4056387337;6931320
131072;10;80;4057094124;4064074494;6980370
131072;10;81;4064784503;4071765746;6981243
131072;10;82;4072462637;4079485825;7023188
131072;10;83;4080194010;4087171784;6977774
131072;10;84;4087881001;4094871277;6990276
131072;10;85;4095566808;4102558730;6991922
131072;10;86;4103248005;4110260799;7012794
131072;10;87;4110976558;4117948274;6971716
131072;10;88;4118647612;4125625612;6978000
131072;10;89;4126321228;4133303566;6982338
131072;10;90;4134012387;4140982003;6969616
131072;10;91;4141693442;4148660012;6966570
131072;10;92;4149363328;4156408982;7045654
131072;10;93;4157124872;4164097889;6973017
131072;10;94;4164801169;4171778576;6977407
131072;10;95;4172492901;4179485076;6992175
131072;10;96;4180173179;4187133651;6960472
131072;10;97;4187835676;4194817280;6981604
131072;10;98;4195531287;4202560402;7029115
131072;10;99;4203263264;4210874423;7611159
262144;10;0;4213005284;4224567093;11561809
262144;10;1;4225820928;4237121015;11300087
262144;10;2;4238374561;4249607167;11232606
262144;10;3;4250771816;4262226459;11454643
262144;10;4;4263506614;4275436976;11930362
262144;10;5;4276631700;4288683716;12052016
262144;10;6;4289868890;6906055;12004461
262144;10;7;8090149;19911466;11821317
262144;10;8;21149322;33163284;12013962
262144;10;9;34347658;46552084;12204426
262144;10;10;47763528;59712136;11948608
262144;10;11;60901420;72530457;11629037
262144;10;12;73632958;84689091;11056133
262144;10;13;85824551;97312872;11488321
262144;10;14;98422583;109761929;11339346
262144;10;15;110868536;121892288;11023752
262144;10;16;123064538;134455742;11391204
262144;10;17;135562887;146643727;11080840
262144;10;18;147888120;159248026;11359906
262144;10;19;160354257;171597853;11243596
262144;10;20;172707606;183766092;11058486
262144;10;21;184874774;196180019;11305245
262144;10;22;197288552;208315121;11026569
262144;10;23;209532129;220617182;11085053
262144;10;24;221727498;233200273;11472775
262144;10;25;234364419;245560512;11196093
262144;10;26;246655086;257896662;11241576
262144;10;27;259002132;270039131;11036999
262144;10;28;271144656;282458454;11313798
262144;10;29;283564493;294750202;11185709
262144;10;30;295855223;306871836;11016613
262144;10;31;307976670;319155405;11178735
262144;10;32;320261863;331466281;11204418
262144;10;33;332708493;343730935;11022442
262144;10;34;344837447;356013443;11175996
262144;10;35;357121541;368134396;11012855
262144;10;36;369249288;380852967;11603679
262144;10;37;381955361;392966015;11010654
262144;10;38;394074490;405133449;11058959
262144;10;39;406227669;417277540;11049871
262144;10;40;418383056;429661504;11278448
262144;10;41;430770848;441960813;11189965
262144;10;42;443069645;454085321;11015676
262144;10;43;455192101;466243378;11051277
262144;10;44;467348323;478535282;11186959
262144;10;45;479645077;490822638;11177561
262144;10;46;491965013;503116273;11151260
262144;10;47;504233385;515280011;11046626
262144;10;48;516388753;527625632;11236879
262144;10;49;528740732;539818187;11077455
262144;10;50;540924372;551929720;11005348
262144;10;51;553036535;564155311;11118776
262144;10;52;565260605;576318812;11058207
262144;10;53;577413402;588446140;11032738
262144;10;54;589604612;600697250;11092638
262144;10;55;601805790;612841186;11035396
262144;10;56;613949630;625903749;11954119
262144;10;57;627172859;639439335;12266476
262144;10;58;640665436;652892117;12226681
262144;10;59;654118105;666386294;12268189
262144;10;60;667615625;679861865;12246240
262144;10;61;681088968;693334433;12245465
262144;10;62;694560907;706797840;12236933
262144;10;63;708023752;720594785;12571033
262144;10;64;721707496;732680493;10972997
262144;10;65;733788681;744806827;11018146
262144;10;66;745981862;757112171;11130309
262144;10;67;758218303;769236081;11017778
262144;10;68;770340949;781417245;11076296
262144;10;69;782523791;793580118;11056327
262144;10;70;794808763;805860496;11051733
262144;10;71;806968515;819313395;12344880
262144;10;72;820422599;831427763;11005164
262144;10;73;832532579;843654383;11121804
262144;10;74;844759434;855827867;11068433
262144;10;75;856921649;867961930;11040281
262144;10;76;869066497;880118099;11051602
262144;10;77;881241402;892280066;11038664
262144;10;78;893384613;904471743;11087130
262144;10;79;905576494;916655135;11078641
262144;10;80;917759750;928763570;11003820
262144;10;81;929868128;940968142;11100014
262144;10;82;942072643;953119482;11046839
262144;10;83;954213225;965264806;11051581
262144;10;84;966371570;977460492;11088922
262144;10;85;978568718;989665512;11096794
262144;10;86;990762422;1001841960;11079538
262144;10;87;1002946539;1014353826;11407287
262144;10;88;1015467641;1026518509;11050868
262144;10;89;1027623967;1038720616;11096649
262144;10;90;1039837201;1050858165;11020964
262144;10;91;1051952130;1063009023;11056893
262144;10;92;1064114331;1075201086;11086755
262144;10;93;1076306125;1087361772;11055647
262144;10;94;1088456392;1099500112;11043720
262144;10;95;1100616056;1111852169;11236113
262144;10;96;1113017615;1124123539;11105924
262144;10;97;1125232806;1136245455;11012649
262144;10;98;1137355489;1148368002;11012513
262144;10;99;1149473016;1160548723;11075707
262144;10;0;1161766831;1172812508;11045677
262144;10;1;1173917822;1184973915;11056093
262144;10;2;1186086723;1197117829;11031106
262144;10;3;1198222886;1209436174;11213288
262144;10;4;1210547751;1221684162;11136411
262144;10;5;1222791330;1233792955;11001625
262144;10;6;1234902149;1245925795;11023646
262144;10;7;1247034693;1258092363;11057670
262144;10;8;1259220918;1270265584;11044666
262144;10;9;1271370831;1282460738;11089907
262144;10;10;1283565839;1294571402;11005563
262144;10;11;1295679067;1306735589;11056522
262144;10;12;1307840810;1318956057;11115247
262144;10;13;1320062005;1331060973;10998968
262144;10;14;1332169680;1343230016;11060336
262144;10;15;1344396081;1355450812;11054731
262144;10;16;1356552402;1367599030;11046628
262144;10;17;1368707774;1379761425;11053651
262144;10;18;1380866556;1391916671;11050115
262144;10;19;1393012589;1404302294;11289705
262144;10;20;1405464928;1416485792;11020864
262144;10;21;1417591146;1428633735;11042589
262144;10;22;1429740278;1440847315;11107037
262144;10;23;1441952295;1453037467;11085172
262144;10;24;1454143465;1465143772;11000307
262144;10;25;1466255454;1477329677;11074223
262144;10;26;1478437662;1489454950;11017288
262144;10;27;1490577308;1502160934;11583626
262144;10;28;1503271087;1514283031;11011944
262144;10;29;1515392059;1526503671;11111612
262144;10;30;1527601679;1538615666;11013987
262144;10;31;1539769369;1550781554;11012185
262144;10;32;1551889598;1562938247;11048649
262144;10;33;1564032377;1575080677;11048300
262144;10;34;1576186008;1587259627;11073619
262144;10;35;1588364572;1599836926;11472354
262144;10;36;1600950958;1611962569;11011611
262144;10;37;1613071686;1624130533;11058847
262144;10;38;1625239342;1636334269;11094927
262144;10;39;1637441340;1648457703;11016363
262144;10;40;1649562652;1660614679;11052027
262144;10;41;1661708598;1672724073;11015475
262144;10;42;1673830143;1685042211;11212068
262144;10;43;1686150854;1697153971;11003117
262144;10;44;1698260338;1709304311;11043973
262144;10;45;1710413333;1721458860;11045527
262144;10;46;1722567308;1733649169;11081861
262144;10;47;1734757757;1745806360;11048603
262144;10;48;1746911180;1757924790;11013610
262144;10;49;1759072536;1770076665;11004129
262144;10;50;1771181613;1782302182;11120569
262144;10;51;1783556852;1795091790;11534938
262144;10;52;1796202689;1807274014;11071325
262144;10;53;1808380063;1819476623;11096560
262144;10;54;1820570869;1831592073;11021204
262144;10;55;1832705562;1843800719;11095157
262144;10;56;1844909550;1855920887;11011337
262144;10;57;1857017693;1868073592;11055899
262144;10;58;1869184304;1880252673;11068369
262144;10;59;1881570806;1892649399;11078593
262144;10;60;1893759119;1904882469;11123350
262144;10;61;1905988602;1917069858;11081256
262144;10;62;1918175257;1929223037;11047780
262144;10;63;1930328278;1941378786;11050508
262144;10;64;1942587612;1953599987;11012375
262144;10;65;1954707753;1965744427;11036674
262144;10;66;1966883933;1978269266;11385333
262144;10;67;1979382958;1990487404;11104446
262144;10;68;1991582894;2002639182;11056288
262144;10;69;2003745322;2014800576;11055254
262144;10;70;2015905566;2026948987;11043421
262144;10;71;2028055807;2039072374;11016567
262144;10;72;2040178496;2051227633;11049137
262144;10;73;2052334557;2063401117;11066560
262144;10;74;2064509077;2075524393;11015316
262144;10;75;2076693982;2087744314;11050332
262144;10;76;2088885821;2099918084;11032263
262144;10;77;2101023193;2112100496;11077303
262144;10;78;2113217725;2124233798;11016073
262144;10;79;2125327664;2136343004;11015340
262144;10;80;2137448765;2148523964;11075199
262144;10;81;2149643645;2160677496;11033851
262144;10;82;2161785201;2173656511;11871310
262144;10;83;2174766158;2185853088;11086930
262144;10;84;2186960214;2198055320;11095106
262144;10;85;2199169532;2210230315;11060783
262144;10;86;2211338296;2222383731;11045435
262144;10;87;2223492200;2234504292;11012092
262144;10;88;2235598114;2246678389;11080275
262144;10;89;2247783136;2258831878;11048742
262144;10;90;2259936706;2271348152;11411446
262144;10;91;2272459891;2283526093;11066202
262144;10;92;2284632411;2295688381;11055970
262144;10;93;2296782855;2307926288;11143433
262144;10;94;2309032900;2320043420;11010520
262144;10;95;2321152221;2332197630;11045409
262144;10;96;2333336340;2344351109;11014769
262144;10;97;2345459305;2356501614;11042309
262144;10;98;2357606204;2368960969;11354765
262144;10;99;2370070501;2381215965;11145464
262144;10;0;2390071624;2401848145;11776521
262144;10;1;2403028983;2414709927;11680944
262144;10;2;2415885571;2427554627;11669056
262144;10;3;2428760179;2440351056;11590877
262144;10;4;2441512861;2453208589;11695728
262144;10;5;2454385434;2466137513;11752079
262144;10;6;2467315018;2479019694;11704676
262144;10;7;2480200105;2491889057;11688952
262144;10;8;2493063341;2504751234;11687893
262144;10;9;2505933305;2517739345;11806040
262144;10;10;2518995825;2530706459;11710634
262144;10;11;2531867174;2543535366;11668192
262144;10;12;2544712566;2557287091;12574525
262144;10;13;2560185064;2572347498;12162434
262144;10;14;2573502306;2585146141;11643835
262144;10;15;2586307536;2598011855;11704319
262144;10;16;2599166037;2610851352;11685315
262144;10;17;2612066427;2623735712;11669285
262144;10;18;2624912136;2636563182;11651046
262144;10;19;2637739589;2649356182;11616593
262144;10;20;2650556875;2662411294;11854419
262144;10;21;2663608515;2675292167;11683652
262144;10;22;2676458136;2688236079;11777943
262144;10;23;2689401531;2701027799;11626268
262144;10;24;2702189843;2713941253;11751410
262144;10;25;2715132617;2726717873;11585256
262144;10;26;2727879058;2739571609;11692551
262144;10;27;2740724466;2752604223;11879757
262144;10;28;2753828356;2765989299;12160943
262144;10;29;2767199664;2778950340;11750676
262144;10;30;2780115999;2791769983;11653984
262144;10;31;2792943624;2804687393;11743769
262144;10;32;2805873985;2817475941;11601956
262144;10;33;2818668451;2830331070;11662619
262144;10;34;2831502745;2843919838;12417093
262144;10;35;2845175628;2856908638;11733010
262144;10;36;2858077634;2869651230;11573596
262144;10;37;2870871228;2882583168;11711940
262144;10;38;2883776741;2895643087;11866346
262144;10;39;2896817808;2908566653;11748845
262144;10;40;2909743909;2921320314;11576405
262144;10;41;2922566780;2934195479;11628699
262144;10;42;2935374401;2947186224;11811823
262144;10;43;2948371369;2960176852;11805483
262144;10;44;2961368451;2973042244;11673793
262144;10;45;2974212704;2986066827;11854123
262144;10;46;2987273087;2999356747;12083660
262144;10;47;3000530921;3012178281;11647360
262144;10;48;3013357799;3025024610;11666811
262144;10;49;3026241716;3038900839;12659123
262144;10;50;3040573595;3052223083;11649488
262144;10;51;3053405380;3065175214;11769834
262144;10;52;3066345178;3078108948;11763770
262144;10;53;3079304245;3091235037;11930792
262144;10;54;3092399527;3104010962;11611435
262144;10;55;3105172192;3116899963;11727771
262144;10;56;3118049898;3129797142;11747244
262144;10;57;3130972952;3143027097;12054145
262144;10;58;3144353605;3155982800;11629195
262144;10;59;3157142635;3168789847;11647212
262144;10;60;3169943336;3181705688;11762352
262144;10;61;3182874565;3194531497;11656932
262144;10;62;3195730249;3207403262;11673013
262144;10;63;3208604861;3220171132;11566271
262144;10;64;3221384038;3233050790;11666752
262144;10;65;3234264964;3245882235;11617271
262144;10;66;3247049569;3258719500;11669931
262144;10;67;3259895703;3271880406;11984703
262144;10;68;3273057093;3284743067;11685974
262144;10;69;3285942812;3297641729;11698917
262144;10;70;3298821632;3310552169;11730537
262144;10;71;3311728377;3323429590;11701213
262144;10;72;3324594826;3336989105;12394279
262144;10;73;3338154983;3349780352;11625369
262144;10;74;3350995595;3362776585;11780990
262144;10;75;3363953552;3375621944;11668392
262144;10;76;3376801063;3388402567;11601504
262144;10;77;3389648121;3401276485;11628364
262144;10;78;3402438904;3414112680;11673776
262144;10;79;3415279123;3427141220;11862097
262144;10;80;3428307102;3439893326;11586224
262144;10;81;3441111461;3452709075;11597614
262144;10;82;3453859115;3465529245;11670130
262144;10;83;3466691919;3478341979;11650060
262144;10;84;3479519830;3491214454;11694624
262144;10;85;3492392617;3504031922;11639305
262144;10;86;3505208508;3516922704;11714196
262144;10;87;3518100812;3529911878;11811066
262144;10;88;3531078673;3542764041;11685368
262144;10;89;3543944439;3555639631;11695192
262144;10;90;3556805490;3568488606;11683116
262144;10;91;3569649909;3581361494;11711585
262144;10;92;3582526560;3594140500;11613940
262144;10;93;3595317580;3607045918;11728338
262144;10;94;3608205115;3619966352;11761237
262144;10;95;3621136097;3632893520;11757423
262144;10;96;3634066222;3645911109;11844887
262144;10;97;3647090674;3658788684;11698010
262144;10;98;3659968194;3671692516;11724322
262144;10;99;3672869021;3684582040;11713019
524288;10;0;3688078166;3710311478;22233312
524288;10;1;3712527704;3734910864;22383160
524288;10;2;3737117130;3759189461;22072331
524288;10;3;3761401211;3783520815;22119604
524288;10;4;3785730282;3807866452;22136170
524288;10;5;3810076804;3833382734;23305930
524288;10;6;3835597083;3857663134;22066051
524288;10;7;3859873727;3882050448;22176721
524288;10;8;3884260636;3906487980;22227344
524288;10;9;3908721794;3930949560;22227766
524288;10;10;3933159050;3955211519;22052469
524288;10;11;3957471060;3980859715;23388655
524288;10;12;3983072708;4005283911;22211203
524288;10;13;4007495227;4029817116;22321889
524288;10;14;4032027387;4054134101;22106714
524288;10;15;4056348105;4078505547;22157442
524288;10;16;4080719727;4102905287;22185560
524288;10;17;4105160072;4127769383;22609311
524288;10;18;4129971617;4152048991;22077374
524288;10;19;4154311222;4176403028;22091806
524288;10;20;4178612953;4200700416;22087463
524288;10;21;4203261026;4225403525;22142499
524288;10;22;4227618069;4249918262;22300193
524288;10;23;4252130011;4274221504;22091493
524288;10;24;4276432405;3606734;22141625
524288;10;25;6244886;28380908;22136022
524288;10;26;30579997;52628647;22048650
524288;10;27;54836861;76900398;22063537
524288;10;28;79143485;101290721;22147236
524288;10;29;103501017;125588137;22087120
524288;10;30;127786364;149954553;22168189
524288;10;31;152166333;174247342;22081009
524288;10;32;176517049;198827112;22310063
524288;10;33;201029551;223191307;22161756
524288;10;34;225402591;247545783;22143192
524288;10;35;249757116;271778738;22021622
524288;10;36;273989606;296414556;22424950
524288;10;37;298619651;320777944;22158293
524288;10;38;322988991;345181458;22192467
524288;10;39;347392679;369411557;22018878
524288;10;40;371654052;394594109;22940057
524288;10;41;396797345;418964646;22167301
524288;10;42;421172519;443275846;22103327
524288;10;43;445486591;467534915;22048324
524288;10;44;469757028;491823903;22066875
524288;10;45;494100165;516182731;22082566
524288;10;46;518404695;540466571;22061876
524288;10;47;542676527;564834743;22158216
524288;10;48;567040353;589611633;22571280
524288;10;49;591823273;613971437;22148164
524288;10;50;616170771;638267932;22097161
524288;10;51;640480700;662723634;22242934
524288;10;52;665184934;687309904;22124970
524288;10;53;689596700;711796042;22199342
524288;10;54;714005886;736558635;22552749
524288;10;55;738814669;761272434;22457765
524288;10;56;763615802;786378317;22762515
524288;10;57;788592630;810968021;22375391
524288;10;58;813176361;835414358;22237997
524288;10;59;837625115;859847583;22222468
524288;10;60;862046664;884281128;22234464
524288;10;61;886498932;908877610;22378678
524288;10;62;911083718;933427400;22343682
524288;10;63;935724130;957890078;22165948
524288;10;64;961004041;983833244;22829203
524288;10;65;986051551;1008323116;22271565
524288;10;66;1010666252;1032983578;22317326
524288;10;67;1035194520;1057368316;22173796
524288;10;68;1059585868;1081901507;22315639
524288;10;69;1084100234;1106387435;22287201
524288;10;70;1108601886;1130961514;22359628
524288;10;71;1133321830;1155521267;22199437
524288;10;72;1157956206;1180252193;22295987
524288;10;73;1182451959;1204728310;22276351
524288;10;74;1206952011;1229324255;22372244
524288;10;75;1231538469;1253775047;22236578
524288;10;76;1256013690;1278691866;22678176
524288;10;77;1280909336;1303209078;22299742
524288;10;78;1305406498;1327708364;22301866
524288;10;79;1329921059;1352149310;22228251
524288;10;80;1354602000;1376931592;22329592
524288;10;81;1379154439;1401651298;22496859
524288;10;82;1403916695;1426182002;22265307
524288;10;83;1428393859;1450580852;22186993
524288;10;84;1452794046;1475157963;22363917
524288;10;85;1477358758;1499796877;22438119
524288;10;86;1502018926;1524240231;22221305
524288;10;87;1526460052;1549133291;22673239
524288;10;88;1551353918;1573638812;22284894
524288;10;89;1575838475;1598719237;22880762
524288;10;90;1600935377;1623226297;22290920
524288;10;91;1625449749;1648080793;22631044
524288;10;92;1650420282;1673345412;22925130
524288;10;93;1675548541;1698058733;22510192
524288;10;94;1700278183;1722639673;22361490
524288;10;95;1724919169;1747503830;22584661
524288;10;96;1749883928;1773571533;23687605
524288;10;97;1776042999;1798715146;22672147
524288;10;98;1800927234;1822988080;22060846
524288;10;99;1825187145;1847231690;22044545
524288;10;0;1849736519;1871803906;22067387
524288;10;1;1874014627;1896051759;22037132
524288;10;2;1898250906;1920348026;22097120
524288;10;3;1922559798;1945438688;22878890
524288;10;4;1947662067;1970019254;22357187
524288;10;5;1972232660;1994471327;22238667
524288;10;6;1996686999;2018857296;22170297
524288;10;7;2021071533;2043666399;22594866
524288;10;8;2045871331;2067937256;22065925
524288;10;9;2070148989;2092181949;22032960
524288;10;10;2094388942;2116477532;22088590
524288;10;11;2118698672;2141090011;22391339
524288;10;12;2143370555;2165685077;22314522
524288;10;13;2167898518;2190119307;22220789
524288;10;14;2192342872;2214757478;22414606
524288;10;15;2216954214;2239181452;22227238
524288;10;16;2241457003;2263493681;22036678
524288;10;17;2265714117;2287821948;22107831
524288;10;18;2290033258;2312080068;22046810
524288;10;19;2314277274;2336341039;22063765
524288;10;20;2338554718;2360570263;22015545
524288;10;21;2362784127;2384834617;22050490
524288;10;22;2387048385;2409091908;22043523
524288;10;23;2411288425;2433660564;22372139
524288;10;24;2435878782;2457898354;22019572
524288;10;25;2460112094;2482374975;22262881
524288;10;26;2484591029;2506629234;22038205
524288;10;27;2508827078;2531230670;22403592
524288;10;28;2533457253;2555708175;22250922
524288;10;29;2557921361;2580279434;22358073
524288;10;30;2582483870;2604747685;22263815
524288;10;31;2606966247;2629339447;22373200
524288;10;32;2631620198;2653647677;22027479
524288;10;33;2655870306;2677912373;22042067
524288;10;34;2680136440;2702166338;22029898
524288;10;35;2704389250;2726471051;22081801
524288;10;36;2728696270;2750767946;22071676
524288;10;37;2752996702;2775404378;22407676
524288;10;38;2777779195;2800422680;22643485
524288;10;39;2802679828;2826746609;24066781
524288;10;40;2828962506;2851464830;22502324
524288;10;41;2853664669;2875963118;22298449
524288;10;42;2878323181;2901151360;22828179
524288;10;43;2903389354;2926238905;22849551
524288;10;44;2928445877;2951066425;22620548
524288;10;45;2953280650;2975565781;22285131
524288;10;46;2977991249;3000653500;22662251
524288;10;47;3002889083;3025371668;22482585
524288;10;48;3027573422;3050276892;22703470
524288;10;49;3052535522;3074731547;22196025
524288;10;50;3076943036;3099559771;22616735
524288;10;51;3102392689;3124872623;22479934
524288;10;52;3127073903;3149472438;22398535
524288;10;53;3151685144;3173752636;22067492
524288;10;54;3175967836;3198830835;22862999
524288;10;55;3201305073;3225841708;24536635
524288;10;56;3228299805;3252864841;24565036
524288;10;57;3255328023;3279868087;24540064
524288;10;58;3282324922;3307245431;24920509
524288;10;59;3309707004;3334241473;24534469
524288;10;60;3336699892;3360871430;24171538
524288;10;61;3363196232;3385225536;22029304
524288;10;62;3387529934;3410490941;22961007
524288;10;63;3412749162;3434999976;22250814
524288;10;64;3437211091;3459648361;22437270
524288;10;65;3461860663;3483960847;22100184
524288;10;66;3486441009;3509700826;23259817
524288;10;67;3511923928;3534079607;22155679
524288;10;68;3536292517;3558680781;22388264
524288;10;69;3560893997;3582987415;22093418
524288;10;70;3585187235;3608806572;23619337
524288;10;71;3611028965;3633109972;22081007
524288;10;72;3635377407;3657618735;22241328
524288;10;73;3659904416;3681997439;22093023
524288;10;74;3684393051;3706656091;22263040
524288;10;75;3708869371;3731173420;22304049
524288;10;76;3733445668;3755464850;22019182
524288;10;77;3757675038;3780057343;22382305
524288;10;78;3782257647;3804531202;22273555
524288;10;79;3806747420;3829197850;22450430
524288;10;80;3831407591;3853477444;22069853
524288;10;81;3855688056;3878129944;22441888
524288;10;82;3880341983;3903003341;22661358
524288;10;83;3905234338;3927732558;22498220
524288;10;84;3929947207;3952036679;22089472
524288;10;85;3954234636;3976667783;22433147
524288;10;86;3978880636;4001775436;22894800
524288;10;87;4003985454;4026511453;22525999
524288;10;88;4028725478;4050831215;22105737
524288;10;89;4053043221;4075400665;22357444
524288;10;90;4077617665;4099691850;22074185
524288;10;91;4101969998;4124310095;22340097
524288;10;92;4126603582;4148711076;22107494
524288;10;93;4150965324;4173867566;22902242
524288;10;94;4176288652;4198505581;22216929
524288;10;95;4200733943;4222926724;22192781
524288;10;96;4225199894;4247570691;22370797
524288;10;97;4249782283;4272517871;22735588
524288;10;98;4274739494;2230850;22458652
524288;10;99;4442372;26611908;22169536
524288;10;0;44658370;67454018;22795648
524288;10;1;69713736;92188397;22474661
524288;10;2;94417083;116539530;22122447
524288;10;3;118739214;141033359;22294145
524288;10;4;143238551;165913531;22674980
524288;10;5;168238071;190545388;22307317
524288;10;6;192920102;215102460;22182358
524288;10;7;217309495;239501697;22192202
524288;10;8;241739345;264497410;22758065
524288;10;9;266704024;288960413;22256389
524288;10;10;291273647;313869371;22595724
524288;10;11;316075687;338276246;22200559
524288;10;12;340477545;363332861;22855316
524288;10;13;365534966;387747589;22212623
524288;10;14;389938706;414275195;24336489
524288;10;15;416511390;438689133;22177743
524288;10;16;440883071;463381291;22498220
524288;10;17;465748054;488877732;23129678
524288;10;18;491173414;515314475;24141061
524288;10;19;517727822;540187413;22459591
524288;10;20;542389173;566009137;23619964
524288;10;21;568372377;591592507;23220130
524288;10;22;593845455;617093291;23247836
524288;10;23;619461213;643132698;23671485
524288;10;24;645526505;669296836;23770331
524288;10;25;671503997;693745973;22241976
524288;10;26;696043216;719893555;23850339
524288;10;27;722408635;746226740;23818105
524288;10;28;748587218;772549371;23962153
524288;10;29;774916098;799140255;24224157
524288;10;30;801501198;825107526;23606328
524288;10;31;827473208;850779695;23306487
524288;10;32;853087335;875660344;22573009
524288;10;33;877865911;901295530;23429619
524288;10;34;903501824;926063987;22562163
524288;10;35;928412307;950578392;22166085
524288;10;36;952773121;975111346;22338225
524288;10;37;977326339;999552978;22226639
524288;10;38;1001757967;1023992568;22234601
524288;10;39;1026237993;1048377859;22139866
524288;10;40;1050710965;1072946961;22235996
524288;10;41;1075152095;1097616531;22464436
524288;10;42;1100040102;1122249840;22209738
524288;10;43;1124565517;1146818612;22253095
524288;10;44;1149020700;1171222517;22201817
524288;10;45;1173441625;1195852370;22410745
524288;10;46;1198060571;1220337981;22277410
524288;10;47;1222533758;1244804872;22271114
524288;10;48;1247009341;1269173169;22163828
524288;10;49;1271378313;1294099501;22721188
524288;10;50;1296320821;1318846970;22526149
524288;10;51;1321047412;1343426780;22379368
524288;10;52;1345628186;1367821825;22193639
524288;10;53;1370022881;1392259722;22236841
524288;10;54;1394498971;1416651758;22152787
524288;10;55;1418875109;1441192719;22317610
524288;10;56;1443427762;1465612190;22184428
524288;10;57;1468265273;1490509283;22244010
524288;10;58;1492710668;1514697481;21986813
524288;10;59;1516907092;1539056799;22149707
524288;10;60;1541260831;1563698012;22437181
524288;10;61;1566046232;1588316615;22270383
524288;10;62;1590544053;1612578489;22034436
524288;10;63;1614779325;1636829073;22049748
524288;10;64;1639033287;1662051049;23017762
524288;10;65;1664309619;1686493066;22183447
524288;10;66;1688696900;1710807318;22110418
524288;10;67;1713008767;1735060863;22052096
524288;10;68;1737255606;1759268833;22013227
524288;10;69;1761473094;1783509427;22036333
524288;10;70;1785712915;1807810425;22097510
524288;10;71;1810012224;1832058551;22046327
524288;10;72;1834253570;1856616913;22363343
524288;10;73;1858875130;1880964595;22089465
524288;10;74;1883169197;1905605545;22436348
524288;10;75;1907844545;1929898451;22053906
524288;10;76;1932098844;1954836688;22737844
524288;10;77;1957135306;1979125802;21990496
524288;10;78;1981330513;2003407852;22077339
524288;10;79;2005603503;2027652220;22048717
524288;10;80;2029852765;2052239873;22387108
524288;10;81;2054489484;2076465189;21975705
524288;10;82;2078667044;2100722463;22055419
524288;10;83;2102958529;2125002060;22043531
524288;10;84;2127205782;2149248112;22042330
524288;10;85;2151449813;2173453143;22003330
524288;10;86;2175653630;2197756620;22102990
524288;10;87;2199952099;2221999302;22047203
524288;10;88;2224203997;2246727005;22523008
524288;10;89;2248965786;2271015272;22049486
524288;10;90;2273216856;2295278399;22061543
524288;10;91;2297470977;2319518442;22047465
524288;10;92;2321723447;2347713301;25989854
524288;10;93;2349924004;2372097306;22173302
524288;10;94;2374356333;2396394973;22038640
524288;10;95;2398596379;2420640144;22043765
524288;10;96;2422863392;2445604760;22741368
524288;10;97;2447812180;2469862949;22050769
524288;10;98;2472068330;2494126898;22058568
524288;10;99;2496328430;2518405071;22076641
1048576;10;0;2526319447;2570503827;44184380
1048576;10;1;2574972130;2619205764;44233634
1048576;10;2;2623613413;2668229951;44616538
1048576;10;3;2672649817;2716935587;44285770
1048576;10;4;2721547842;2766009032;44461190
1048576;10;5;2770489352;2814727867;44238515
1048576;10;6;2819427886;2863899498;44471612
1048576;10;7;2868318516;2912759490;44440974
1048576;10;8;2917165100;2961403973;44238873
1048576;10;9;2965826739;3010052751;44226012
1048576;10;10;3014794688;3059324515;44529827
1048576;10;11;3063750505;3107973740;44223235
1048576;10;12;3112426962;3157150778;44723816
1048576;10;13;3161570053;3205947535;44377482
1048576;10;14;3210553677;3255063192;44509515
1048576;10;15;3259492069;3303793535;44301466
1048576;10;16;3308197381;3352441655;44244274
1048576;10;17;3356934711;3401027482;44092771
1048576;10;18;3405683109;3450184092;44500983
1048576;10;19;3454638654;3498778033;44139379
1048576;10;20;3504041536;3548538718;44497182
1048576;10;21;3552951414;3598300825;45349411
1048576;10;22;3603134923;3647552509;44417586
1048576;10;23;3651962876;3696256604;44293728
1048576;10;24;3700683570;3744878575;44195005
1048576;10;25;3749283843;3794853427;45569584
1048576;10;26;3799371758;3843973550;44601792
1048576;10;27;3848394591;3893252785;44858194
1048576;10;28;3897758965;3942029890;44270925
1048576;10;29;3946432882;3990986221;44553339
1048576;10;30;3995404959;4040002504;44597545
1048576;10;31;4044411527;4088727246;44315719
1048576;10;32;4093148313;4137393304;44244991
1048576;10;33;4141797861;4186450348;44652487
1048576;10;34;4190956818;4235236448;44279630
1048576;10;35;4239651693;4283997976;44346283
1048576;10;36;4288448238;37693735;44212793
1048576;10;37;42176595;86383965;44207370
1048576;10;38;90893684;135133535;44239851
1048576;10;39;139548892;183994161;44445269
1048576;10;40;188501078;232758925;44257847
1048576;10;41;237216897;281621887;44404990
1048576;10;42;286030705;330359170;44328465
1048576;10;43;334776687;380197413;45420726
1048576;10;44;384625950;429049147;44423197
1048576;10;45;433477925;478186673;44708748
1048576;10;46;482605488;527666260;45060772
1048576;10;47;532080707;576280164;44199457
1048576;10;48;580686629;624933553;44246924
1048576;10;49;629346986;673857962;44510976
1048576;10;50;678268799;722675522;44406723
1048576;10;51;727092756;771855571;44762815
1048576;10;52;776315411;820554294;44238883
1048576;10;53;825012052;869717669;44705617
1048576;10;54;874126521;918340072;44213551
1048576;10;55;922793318;967019431;44226113
1048576;10;56;971421115;1015599669;44178554
1048576;10;57;1020047347;1064797794;44750447
1048576;10;58;1069218510;1113504938;44286428
1048576;10;59;1117958474;1162739885;44781411
1048576;10;60;1167158227;1212366469;45208242
1048576;10;61;1216787279;1261372850;44585571
1048576;10;62;1265783968;1310129551;44345583
1048576;10;63;1314544022;1358764962;44220940
1048576;10;64;1363174713;1407383359;44208646
1048576;10;65;1411796642;1456253087;44456445
1048576;10;66;1460673364;1504850610;44177246
1048576;10;67;1509311641;1553521406;44209765
1048576;10;68;1557925520;1602172673;44247153
1048576;10;69;1606592866;1650770555;44177689
1048576;10;70;1655175305;1699391569;44216264
1048576;10;71;1703846417;1748016018;44169601
1048576;10;72;1752465830;1796743519;44277689
1048576;10;73;1801177673;1845416813;44239140
1048576;10;74;1849832314;1894015667;44183353
1048576;10;75;1898446760;1942646611;44199851
1048576;10;76;1947100911;1991280769;44179858
1048576;10;77;1995686233;2039884639;44198406
1048576;10;78;2044302869;2088515737;44212868
1048576;10;79;2092950161;2137147762;44197601
1048576;10;80;2141597232;2185819283;44222051
1048576;10;81;2190222091;2235394817;45172726
1048576;10;82;2239818579;2284356340;44537761
1048576;10;83;2288826989;2334193793;45366804
1048576;10;84;2338615099;2382782765;44167666
1048576;10;85;2387185658;2432993624;45807966
1048576;10;86;2437414394;2481712587;44298193
1048576;10;87;2486123630;2530918386;44794756
1048576;10;88;2535342205;2579569847;44227642
1048576;10;89;2583974007;2630446862;46472855
1048576;10;90;2634948857;2679115808;44166951
1048576;10;91;2683561940;2728205900;44643960
1048576;10;92;2732623930;2776846512;44222582
1048576;10;93;2781307815;2825831873;44524058
1048576;10;94;2830278062;2874448460;44170398
1048576;10;95;2879122660;2923610017;44487357
1048576;10;96;2928033963;2972209853;44175890
1048576;10;97;2976652437;3021002612;44350175
1048576;10;98;3025446420;3070088398;44641978
1048576;10;99;3074595369;3118881469;44286100
1048576;10;0;3123964527;3168147923;44183396
1048576;10;1;3172606380;3217234480;44628100
1048576;10;2;3221705660;3265922973;44217313
1048576;10;3;3270327285;3314506199;44178914
1048576;10;4;3318968848;3363807081;44838233
1048576;10;5;3369081349;3413487683;44406334
1048576;10;6;3417910538;3462188613;44278075
1048576;10;7;3466611466;3512023829;45412363
1048576;10;8;3516502926;3560846226;44343300
1048576;10;9;3565312119;3609645739;44333620
1048576;10;10;3614060412;3659515167;45454755
1048576;10;11;3664066260;3708497935;44431675
1048576;10;12;3712919383;3757223426;44304043
1048576;10;13;3761638501;3805818301;44179800
1048576;10;14;3810283063;3854923380;44640317
1048576;10;15;3859434453;3903787499;44353046
1048576;10;16;3908206655;3952409877;44203222
1048576;10;17;3956813199;4001048784;44235585
1048576;10;18;4005496520;4050984565;45488045
1048576;10;19;4055467419;4099726183;44258764
1048576;10;20;4104184796;4149074220;44889424
1048576;10;21;4153655714;4197840331;44184617
1048576;10;22;4202289789;4246549969;44260180
1048576;10;23;4250964442;270983;44273837
1048576;10;24;4677640;49605064;44927424
1048576;10;25;54043471;98249808;44206337
1048576;10;26;102665183;146874649;44209466
1048576;10;27;151423291;196202780;44779489
1048576;10;28;200687687;244904048;44216361
1048576;10;29;249311880;293524948;44213068
1048576;10;30;297946631;342586211;44639580
1048576;10;31;346995703;391231775;44236072
1048576;10;32;395653322;440019375;44366053
1048576;10;33;444436850;488641179;44204329
1048576;10;34;493091140;538096935;45005795
1048576;10;35;542577811;586758419;44180608
1048576;10;36;591162032;635425898;44263866
1048576;10;37;639843419;684074066;44230647
1048576;10;38;688476469;734245517;45769048
1048576;10;39;738704676;782895508;44190832
1048576;10;40;787331599;831543118;44211519
1048576;10;41;835961633;880763752;44802119
1048576;10;42;885180927;930081677;44900750
1048576;10;43;934492103;978714148;44222045
1048576;10;44;983131609;1027359055;44227446
1048576;10;45;1031800106;1075944754;44144648
1048576;10;46;1080361571;1125433978;45072407
1048576;10;47;1129844341;1174686846;44842505
1048576;10;48;1179148863;1224190863;45042000
1048576;10;49;1228696820;1273044531;44347711
1048576;10;50;1277461649;1322040459;44578810
1048576;10;51;1326447470;1370709618;44262148
1048576;10;52;1375129588;1419752140;44622552
1048576;10;53;1424181410;1468675716;44494306
1048576;10;54;1473080778;1517324203;44243425
1048576;10;55;1521768404;1565943189;44174785
1048576;10;56;1570347615;1615132339;44784724
1048576;10;57;1619551867;1664025609;44473742
1048576;10;58;1668433860;1712666156;44232296
1048576;10;59;1717112323;1761630962;44518639
1048576;10;60;1766081035;1810324412;44243377
1048576;10;61;1814738553;1858962188;44223635
1048576;10;62;1863400099;1907525458;44125359
1048576;10;63;1912013960;1956671243;44657283
1048576;10;64;1961078388;2005321744;44243356
1048576;10;65;2009737092;2054043222;44306130
1048576;10;66;2058450859;2102648464;44197605
1048576;10;67;2107066247;2151784603;44718356
1048576;10;68;2156192085;2200659422;44467337
1048576;10;69;2205171548;2249476476;44304928
1048576;10;70;2253896656;2298650324;44753668
1048576;10;71;2303058263;2347358719;44300456
1048576;10;72;2351779211;2396902344;45123133
1048576;10;73;2401324304;2445597732;44273428
1048576;10;74;2450001078;2494663336;44662258
1048576;10;75;2499083328;2544180291;45096963
1048576;10;76;2548600165;2592792188;44192023
1048576;10;77;2597232190;2641446858;44214668
1048576;10;78;2645864193;2690022093;44157900
1048576;10;79;2694429193;2738787254;44358061
1048576;10;80;2743254096;2787404410;44150314
1048576;10;81;2791845846;2836325506;44479660
1048576;10;82;2840743144;2884971218;44228074
1048576;10;83;2889417099;2934406909;44989810
1048576;10;84;2938875151;2983059359;44184208
1048576;10;85;2987466522;3031718468;44251946
1048576;10;86;3036133535;3080318815;44185280
1048576;10;87;3084738074;3129684151;44946077
1048576;10;88;3134104611;3178362776;44258165
1048576;10;89;3182765375;3227525803;44760428
1048576;10;90;3231973092;3276193349;44220257
1048576;10;91;3280608539;3324852671;44244132
1048576;10;92;3329256603;3373559364;44302761
1048576;10;93;3377976979;3422699588;44722609
1048576;10;94;3427106887;3471312100;44205213
1048576;10;95;3475731037;3519970109;44239072
1048576;10;96;3524373277;3568535846;44162569
1048576;10;97;3572994079;3617732151;44738072
1048576;10;98;3622184353;3666415223;44230870
1048576;10;99;3670850560;3715245071;44394511
1048576;10;0;3750813315;3798952556;48139241
1048576;10;1;3803686330;3851239239;47552909
1048576;10;2;3855975390;3904176412;48201022
1048576;10;3;3908986188;3956436841;47450653
1048576;10;4;3961205752;4008739549;47533797
1048576;10;5;4013491841;4060996373;47504532
1048576;10;6;4066226964;4113852012;47625048
1048576;10;7;4118602725;4166097133;47494408
1048576;10;8;4170846603;4218353884;47507281
1048576;10;9;4223111956;4271146297;48034341
1048576;10;10;4275877632;29137167;48226831
1048576;10;11;33974821;82229944;48255123
1048576;10;12;87014808;134463237;47448429
1048576;10;13;139231000;187283839;48052839
1048576;10;14;192020444;239680012;47659568
1048576;10;15;244475185;292321464;47846279
1048576;10;16;297084385;344563678;47479293
1048576;10;17;349307080;396728931;47421851
1048576;10;18;401486999;448971778;47484779
1048576;10;19;454840133;502431544;47591411
1048576;10;20;507173103;554689605;47516502
1048576;10;21;559438232;606871554;47433322
1048576;10;22;611601780;659461870;47860090
1048576;10;23;664231461;711702198;47470737
1048576;10;24;716449482;763900149;47450667
1048576;10;25;768655469;816090950;47435481
1048576;10;26;820829089;869177785;48348696
1048576;10;27;873913503;921366907;47453404
1048576;10;28;926155712;974409160;48253448
1048576;10;29;979136723;1026740360;47603637
1048576;10;30;1031667351;1079362184;47694833
1048576;10;31;1084141320;1131596956;47455636
1048576;10;32;1136344911;1183817259;47472348
1048576;10;33;1188584224;1238100199;49515975
1048576;10;34;1242851861;1290323827;47471966
1048576;10;35;1295089879;1342760212;47670333
1048576;10;36;1347499471;1395682410;48182939
1048576;10;37;1400466116;1448076310;47610194
1048576;10;38;1452857509;1500217780;47360271
1048576;10;39;1504976727;1552415102;47438375
1048576;10;40;1557196627;1604606429;47409802
1048576;10;41;1609538173;1657048854;47510681
1048576;10;42;1661868547;1709889212;48020665
1048576;10;43;1714779551;1762322236;47542685
1048576;10;44;1767104168;1815102634;47998466
1048576;10;45;1819869554;1867334157;47464603
1048576;10;46;1872111478;1919582272;47470794
1048576;10;47;1924359496;1971775085;47415589
1048576;10;48;1976530682;2024154853;47624171
1048576;10;49;2028874211;2076381863;47507652
1048576;10;50;2081102952;2129885623;48782671
1048576;10;51;2134669143;2182235263;47566120
1048576;10;52;2186988841;2235231965;48243124
1048576;10;53;2239971614;2287395686;47424072
1048576;10;54;2292157380;2339569268;47411888
1048576;10;55;2344348675;2392661992;48313317
1048576;10;56;2397404285;2444877253;47472968
1048576;10;57;2449613384;2497502351;47888967
1048576;10;58;2502273537;2549725313;47451776
1048576;10;59;2554473801;2604701441;50227640
1048576;10;60;2609500387;2657054475;47554088
1048576;10;61;2661849237;2709341408;47492171
1048576;10;62;2714086631;2761587307;47500676
1048576;10;63;2766334902;2814369789;48034887
1048576;10;64;2819121360;2867077627;47956267
1048576;10;65;2871919100;2919535125;47616025
1048576;10;66;2924270933;2972058244;47787311
1048576;10;67;2976844443;3025043037;48198594
1048576;10;68;3029810985;3078229964;48418979
1048576;10;69;3082978109;3130409099;47430990
1048576;10;70;3135469226;3183374409;47905183
1048576;10;71;3188106846;3235399039;47292193
1048576;10;72;3240134309;3287680173;47545864
1048576;10;73;3292469156;3340218541;47749385
1048576;10;74;3344955036;3393181711;48226675
1048576;10;75;3397956019;3445551536;47595517
1048576;10;76;3450319931;3497796581;47476650
1048576;10;77;3502547539;3550616871;48069332
1048576;10;78;3555363864;3603164706;47800842
1048576;10;79;3607922537;3656000767;48078230
1048576;10;80;3660756532;3708213974;47457442
1048576;10;81;3712940337;3760811007;47870670
1048576;10;82;3765562082;3813034440;47472358
1048576;10;83;3817807710;3865351949;47544239
1048576;10;84;3870147360;3917572216;47424856
1048576;10;85;3922299293;3970483881;48184588
1048576;10;86;3975322173;4022888892;47566719
1048576;10;87;4028341877;4076995918;48654041
1048576;10;88;4081743336;4129968296;48224960
1048576;10;89;4134784428;4182653424;47868996
1048576;10;90;4187477960;4235253198;47775238
1048576;10;91;4240036960;4287524733;47487773
1048576;10;92;4292265716;45238594;47940174
1048576;10;93;49978785;98776759;48797974
1048576;10;94;103541270;151355827;47814557
1048576;10;95;156101332;203500500;47399168
1048576;10;96;208281783;256242875;47961092
1048576;10;97;261046084;309539306;48493222
1048576;10;98;314351623;361895484;47543861
1048576;10;99;366645156;414527077;47881921
2097152;10;0;429589007;519016791;89427784
2097152;10;1;527912649;616872341;88959692
2097152;10;2;625823970;715801844;89977874
2097152;10;3;724770634;814447753;89677119
2097152;10;4;823508063;916567328;93059265
2097152;10;5;925453583;1014353922;88900339
2097152;10;6;1023206969;1113278512;90071543
2097152;10;7;1122125617;1211524623;89399006
2097152;10;8;1220556064;1314716837;94160773
2097152;10;9;1324702796;1423709287;99006491
2097152;10;10;1433335815;1529673545;96337730
2097152;10;11;1539158426;1635024498;95866072
2097152;10;12;1644212741;1733827625;89614884
2097152;10;13;1742689155;1831524587;88835432
2097152;10;14;1840386623;1929026846;88640223
2097152;10;15;1937895915;2027912570;90016655
2097152;10;16;2036785871;2126360662;89574791
2097152;10;17;2135217674;2226123485;90905811
2097152;10;18;2235043672;2325208324;90164652
2097152;10;19;2334043083;2428499093;94456010
2097152;10;20;2437418230;2527913609;90495379
2097152;10;21;2536999053;2627827603;90828550
2097152;10;22;2636879460;2727022319;90142859
2097152;10;23;2736099205;2828170665;92071460
2097152;10;24;2837022520;2925982655;88960135
2097152;10;25;2934822912;3023711431;88888519
2097152;10;26;3032701145;3121226750;88525605
2097152;10;27;3130094251;3219183148;89088897
2097152;10;28;3228054039;3317012712;88958673
2097152;10;29;3325849843;3415673007;89823164
2097152;10;30;3424498433;3512902400;88403967
2097152;10;31;3521729044;3622477805;100748761
2097152;10;32;3631510192;3739146303;107636111
2097152;10;33;3750057440;3854031029;103973589
2097152;10;34;3864253729;3965559145;101305416
2097152;10;35;3975612152;4077227898;101615746
2097152;10;36;4087082384;4186188225;99105841
2097152;10;37;4196173299;1268966;100062963
2097152;10;38;11290046;119203379;107913333
2097152;10;39;130382370;238427758;108045388
2097152;10;40;247954529;344012028;96057499
2097152;10;41;356750920;452235728;95484808
2097152;10;42;461773745;558744597;96970852
2097152;10;43;568205300;665036641;96831341
2097152;10;44;674247461;766288915;92041454
2097152;10;45;775560726;880654781;105094055
2097152;10;46;890229071;989515404;99286333
2097152;10;47;999074287;1094478136;95403849
2097152;10;48;1104117831;1201175806;97057975
2097152;10;49;1212099462;1315609474;103510012
2097152;10;50;1325305233;1424545686;99240453
2097152;10;51;1435049078;1536666008;101616930
2097152;10;52;1546212318;1641699808;95487490
2097152;10;53;1651246504;1749170820;97924316
2097152;10;54;1758724916;1859855647;101130731
2097152;10;55;1869543512;1964781187;95237675
2097152;10;56;1974272141;2069741862;95469721
2097152;10;57;2079259616;2174447160;95187544
2097152;10;58;2183921362;2282889789;98968427
2097152;10;59;2292400443;2393202152;100801709
2097152;10;60;2404191183;2513398095;109206912
2097152;10;61;2524462587;2633905916;109443329
2097152;10;62;2645467076;2747774869;102307793
2097152;10;63;2758584416;2857203659;98619243
2097152;10;64;2868141976;2965860069;97718093
2097152;10;65;2975433076;3074772071;99338995
2097152;10;66;3085206855;3193031616;107824761
2097152;10;67;3203017055;3297071146;94054091
2097152;10;68;3305906883;3396144176;90237293
2097152;10;69;3405176785;3502278325;97101540
2097152;10;70;3511874466;3607560203;95685737
2097152;10;71;3617847731;3718250443;100402712
2097152;10;72;3728108922;3827294455;99185533
2097152;10;73;3836871030;3934629051;97758021
2097152;10;74;3943748924;4043467666;99718742
2097152;10;75;4054017798;4150271799;96254001
2097152;10;76;4159155033;4252843446;93688413
2097152;10;77;4261778264;63608166;96797198
2097152;10;78;73075294;167509355;94434061
2097152;10;79;176694738;273375491;96680753
2097152;10;80;284179624;373487790;89308166
2097152;10;81;382322879;470681609;88358730
2097152;10;82;479516371;567918946;88402575
2097152;10;83;576742746;665261604;88518858
2097152;10;84;674091582;762988513;88896931
2097152;10;85;771867028;861995984;90128956
2097152;10;86;871186519;960186315;88999796
2097152;10;87;969115604;1059187116;90071512
2097152;10;88;1068187150;1164367270;96180120
2097152;10;89;1174867647;1272885807;98018160
2097152;10;90;1281817762;1376612496;94794734
2097152;10;91;1386264152;1482992312;96728160
2097152;10;92;1506412517;1618704422;112291905
2097152;10;93;1629420971;1742025026;112604055
2097152;10;94;1751781577;1847636992;95855415
2097152;10;95;1857310381;1952604905;95294524
2097152;10;96;1962028506;2060396717;98368211
2097152;10;97;2071611151;2179169695;107558544
2097152;10;98;2188716262;2286379261;97662999
2097152;10;99;2295874180;2395962880;100088700
2097152;10;0;2406859806;2502344601;95484795
2097152;10;1;2511855176;2602845841;90990665
2097152;10;2;2611750756;2702693919;90943163
2097152;10;3;2712275902;2811742719;99466817
2097152;10;4;2822402919;2920258688;97855769
2097152;10;5;2929321069;3022895933;93574864
2097152;10;6;3032290193;3123858421;91568228
2097152;10;7;3133115836;3225387055;92271219
2097152;10;8;3235071950;3333422405;98350455
2097152;10;9;3343230968;3438887889;95656921
2097152;10;10;3448226641;3543399474;95172833
2097152;10;11;3552871869;3650359424;97487555
2097152;10;12;3660240536;3751825039;91584503
2097152;10;13;3761079089;3853013415;91934326
2097152;10;14;3862173006;3954831644;92658638
2097152;10;15;3964147290;4054597235;90449945
2097152;10;16;4063498495;4153731364;90232869
2097152;10;17;4163365206;4257893996;94528790
2097152;10;18;4267283154;61746783;89430925
2097152;10;19;70664405;165458284;94793879
2097152;10;20;174706577;265526143;90819566
2097152;10;21;274361391;363971709;89610318
2097152;10;22;372804301;463718561;90914260
2097152;10;23;472776012;563537607;90761595
2097152;10;24;572727993;664657902;91929909
2097152;10;25;674677023;764213150;89536127
2097152;10;26;773077998;865135654;92057656
2097152;10;27;874743391;969173328;94429937
2097152;10;28;978646590;1071649239;93002649
2097152;10;29;1081233963;1177201351;95967388
2097152;10;30;1186101730;1286867569;100765839
2097152;10;31;1297816408;1396064226;98247818
2097152;10;32;1405039142;1497907627;92868485
2097152;10;33;1507047250;1606010739;98963489
2097152;10;34;1615102249;1718601872;103499623
2097152;10;35;1728147892;1822705762;94557870
2097152;10;36;1831615365;1925376029;93760664
2097152;10;37;1934241483;2023538749;89297266
2097152;10;38;2032444994;2124877712;92432718
2097152;10;39;2133818577;2232170518;98351941
2097152;10;40;2241008053;2330395672;89387619
2097152;10;41;2339256389;2430297301;91040912
2097152;10;42;2439784716;2533106563;93321847
2097152;10;43;2542095929;2636445700;94349771
2097152;10;44;2645680894;2738610613;92929719
2097152;10;45;2747494591;2836590616;89096025
2097152;10;46;2845451814;2935519025;90067211
2097152;10;47;2944427376;3033026339;88598963
2097152;10;48;3043134543;3131919199;88784656
2097152;10;49;3140924315;3232657765;91733450
2097152;10;50;3242820245;3346307577;103487332
2097152;10;51;3357813019;3449356710;91543691
2097152;10;52;3458217077;3546692634;88475557
2097152;10;53;3555524552;3644643703;89119151
2097152;10;54;3653542727;3747345101;93802374
2097152;10;55;3756202892;3845920564;89717672
2097152;10;56;3854851446;3944943576;90092130
2097152;10;57;3953751417;4044961305;91209888
2097152;10;58;4053791392;4143096918;89305526
2097152;10;59;4151959002;4240567480;88608478
2097152;10;60;4249402569;45370278;90935005
2097152;10;61;54218258;144007003;89788745
2097152;10;62;152855135;247649937;94794802
2097152;10;63;256555233;351742879;95187646
2097152;10;64;361311000;454596305;93285305
2097152;10;65;464170442;556452942;92282500
2097152;10;66;565484025;657179375;91695350
2097152;10;67;666891447;763106674;96215227
2097152;10;68;771975800;861563094;89587294
2097152;10;69;871818595;970944121;99125526
2097152;10;70;981301773;1082353918;101052145
2097152;10;71;1092568207;1189159555;96591348
2097152;10;72;1197998917;1288387522;90388605
2097152;10;73;1297799122;1389437198;91638076
2097152;10;74;1399398665;1499836440;100437775
2097152;10;75;1510046998;1601945950;91898952
2097152;10;76;1611212757;1705959186;94746429
2097152;10;77;1716429503;1806815311;90385808
2097152;10;78;1815753456;1905764996;90011540
2097152;10;79;1915338998;2006064064;90725066
2097152;10;80;2015356979;2111789176;96432197
2097152;10;81;2120839936;2217301159;96461223
2097152;10;82;2226270188;2323715750;97445562
2097152;10;83;2333009198;2430607463;97598265
2097152;10;84;2439606024;2528460846;88854822
2097152;10;85;2537310552;2629282487;91971935
2097152;10;86;2639726738;2734348453;94621715
2097152;10;87;2745270076;2846955489;101685413
2097152;10;88;2857021979;2959719949;102697970
2097152;10;89;2969900367;3071330644;101430277
2097152;10;90;3081588044;3183406121;101818077
2097152;10;91;3193682490;3295887998;102205508
2097152;10;92;3305988963;3407272082;101283119
2097152;10;93;3417481391;3521295638;103814247
2097152;10;94;3531476775;3634124092;102647317
2097152;10;95;3644434730;3746682211;102247481
2097152;10;96;3756910146;3858504511;101594365
2097152;10;97;3868627864;3971522871;102895007
2097152;10;98;3981642914;4083185553;101542639
2097152;10;99;4093334559;4195605810;102271251
2097152;10;0;29779688;256067514;226287826
2097152;10;1;278532482;504026991;225494509
2097152;10;2;527504786;753970659;226465873
2097152;10;3;776527595;1001784781;225257186
2097152;10;4;1024203996;1249313493;225109497
2097152;10;5;1271879671;1498617306;226737635
2097152;10;6;1521211967;1746262663;225050696
2097152;10;7;1768839473;1995037642;226198169
2097152;10;8;2017587848;2242677229;225089381
2097152;10;9;2266375001;2493293221;226918220
2097152;10;10;2515711222;2741463748;225752526
2097152;10;11;2763869019;2989572658;225703639
2097152;10;12;3012043439;3236887686;224844247
2097152;10;13;3259470779;3484254750;224783971
2097152;10;14;3506761473;3731817831;225056358
2097152;10;15;3754458017;3981482310;227024293
2097152;10;16;4005446687;4254970153;249523466
2097152;10;17;4279143671;217336921;233160546
2097152;10;18;240017743;470668607;230650864
2097152;10;19;494557380;722613207;228055827
2097152;10;20;745096011;970748794;225652783
2097152;10;21;993260056;1221534130;228274074
2097152;10;22;1243981467;1469642370;225660903
2097152;10;23;1492109870;1720116956;228007086
2097152;10;24;1743128791;1969046306;225917515
2097152;10;25;1991589757;2218185620;226595863
2097152;10;26;2240796469;2465643905;224847436
2097152;10;27;2488127040;2714922669;226795629
2097152;10;28;2737396065;2965597382;228201317
2097152;10;29;2989159776;3214615204;225455428
2097152;10;30;3237106685;3462896535;225789850
2097152;10;31;3485694091;3711466551;225772460
2097152;10;32;3733859386;3959579957;225720571
2097152;10;33;3982444631;4211833811;229389180
2097152;10;34;4234413326;165861347;226415317
2097152;10;35;188350122;418721954;230371832
2097152;10;36;441460859;666844242;225383383
2097152;10;37;689674750;915433313;225758563
2097152;10;38;937974196;1164765870;226791674
2097152;10;39;1187246591;1415515081;228268490
2097152;10;40;1438716703;1663835804;225119101
2097152;10;41;1686432720;1914505677;228072957
2097152;10;42;1937021814;2163696193;226674379
2097152;10;43;2186249764;2413828264;227578500
2097152;10;44;2436262534;2662225546;225963012
2097152;10;45;2684744609;2910390094;225645485
2097152;10;46;2932868591;3159767092;226898501
2097152;10;47;3182232987;3409639235;227406248
2097152;10;48;3432425318;3659107609;226682291
2097152;10;49;3681832152;3907805147;225972995
2097152;10;50;3930382172;4155810548;225428376
2097152;10;51;4178878536;111459434;227548194
2097152;10;52;133906055;359162608;225256553
2097152;10;53;381631477;607508140;225876663
2097152;10;54;630022789;855901797;225879008
2097152;10;55;878521706;1105131358;226609652
2097152;10;56;1127600827;1352742791;225141964
2097152;10;57;1375670008;1601969769;226299761
2097152;10;58;1624417844;1851330618;226912774
2097152;10;59;1873908651;2100890907;226982256
2097152;10;60;2123352346;2348457487;225105141
2097152;10;61;2370899181;2596519446;225620265
2097152;10;62;2619007296;2846003434;226996138
2097152;10;63;2869350782;3096531416;227180634
2097152;10;64;3119036988;3345943367;226906379
2097152;10;65;3368390326;3595578496;227188170
2097152;10;66;3618239434;3856753605;238514171
2097152;10;67;3879712044;4106112244;226400200
2097152;10;68;4128794537;59591878;225764637
2097152;10;69;82500001;308240122;225740121
2097152;10;70;330920849;557677359;226756510
2097152;10;71;580216941;807439236;227222295
2097152;10;72;830206852;1056595976;226389124
2097152;10;73;1079176775;1304361632;225184857
2097152;10;74;1327040305;1554251703;227211398
2097152;10;75;1576664913;1802116052;225451139
2097152;10;76;1824729829;2049694841;224965012
2097152;10;77;2072784835;2299128937;226344102
2097152;10;78;2321715305;2547381800;225666495
2097152;10;79;2569790742;2796126373;226335631
2097152;10;80;2818654425;3082899021;264244596
2097152;10;81;3107258817;3335580691;228321874
2097152;10;82;3357921904;3584061772;226139868
2097152;10;83;3607413643;3835009322;227595679
2097152;10;84;3857564070;4084803062;227238992
2097152;10;85;4107725833;37980099;225221562
2097152;10;86;60447130;290138965;229691835
2097152;10;87;312598014;538848917;226250903
2097152;10;88;561835296;789009563;227174267
2097152;10;89;811554714;1040206071;228651357
2097152;10;90;1062880981;1289077158;226196177
2097152;10;91;1311490688;1538759574;227268886
2097152;10;92;1561214600;1787089983;225875383
2097152;10;93;1809758959;2035374315;225615356
2097152;10;94;2057870457;2283640259;225769802
2097152;10;95;2306581491;2533519963;226938472
2097152;10;96;2556509983;2784611950;228101967
2097152;10;97;2807098368;3032442469;225344101
2097152;10;98;3055031399;3282135011;227103612
2097152;10;99;3304922806;3530042067;225119261
4194304;10;0;3565047373;3769672798;204625425
4194304;10;1;3789995075;3995073242;205078167
4194304;10;2;4015591348;4222163078;206571730
4194304;10;3;4242963987;155128735;207132044
4194304;10;4;175505741;381546160;206040419
4194304;10;5;402520567;607842553;205321986
4194304;10;6;628173427;833392648;205219221
4194304;10;7;853919530;1059171274;205251744
4194304;10;8;1079900231;1284247562;204347331
4194304;10;9;1304701433;1512086199;207384766
4194304;10;10;1532657016;1737294687;204637671
4194304;10;11;1757720605;1964304397;206583792
4194304;10;12;1984755285;2190755789;206000504
4194304;10;13;2211356604;2416353104;204996500
4194304;10;14;2436831833;2642714410;205882577
4194304;10;15;2663091890;2867798671;204706781
4194304;10;16;2888650621;3095235199;206584578
4194304;10;17;3115535283;3320576297;205041014
4194304;10;18;3341036334;3545555601;204519267
4194304;10;19;3566933966;3772243147;205309181
4194304;10;20;3792681000;3998440502;205759502
4194304;10;21;4018806764;4224669736;205862972
4194304;10;22;4245304735;154493865;204156426
4194304;10;23;175035088;384024809;208989721
4194304;10;24;404515321;609455560;204940239
4194304;10;25;630110829;834912142;204801313
4194304;10;26;855418495;1064274034;208855539
4194304;10;27;1085357013;1289770739;204413726
4194304;10;28;1310362586;1519466964;209104378
4194304;10;29;1540141155;1745344181;205203026
4194304;10;30;1765924418;1971938507;206014089
4194304;10;31;1992440767;2197192586;204751819
4194304;10;32;2218191048;2423232028;205040980
4194304;10;33;2443710207;2649680344;205970137
4194304;10;34;2669986113;2876744178;206758065
4194304;10;35;2898285945;3104823689;206537744
4194304;10;36;3125125098;3331785241;206660143
4194304;10;37;3352373082;3558161636;205788554
4194304;10;38;3578834851;3785251175;206416324
4194304;10;39;3805540246;4010972142;205431896
4194304;10;40;4031856015;4237448330;205592315
4194304;10;41;4258350567;169905549;206522278
4194304;10;42;190121531;396165322;206043791
4194304;10;43;416620723;622705328;206084605
4194304;10;44;643007858;849895055;206887197
4194304;10;45;870610994;1076189233;205578239
4194304;10;46;1096606068;1301713324;205107256
4194304;10;47;1322426410;1528777813;206351403
4194304;10;48;1549609429;1757381471;207772042
4194304;10;49;1777818579;1983964938;206146359
4194304;10;50;2004243229;2211086140;206842911
4194304;10;51;2231817450;2438066340;206248890
4194304;10;52;2458360870;2664313653;205952783
4194304;10;53;2684719732;2889479426;204759694
4194304;10;54;2910032941;3115743567;205710626
4194304;10;55;3136144939;3342248630;206103691
4194304;10;56;3362690651;3604242342;241551691
4194304;10;57;3627442739;3833237779;205795040
4194304;10;58;3853861016;4058994053;205133037
4194304;10;59;4079487617;4285046965;205559348
4194304;10;60;10529948;216173172;205643224
4194304;10;61;236368155;442029439;205661284
4194304;10;62;462853125;667777225;204924100
4194304;10;63;688154453;892208661;204054208
4194304;10;64;912640696;1119599623;206958927
4194304;10;65;1139988469;1346087803;206099334
4194304;10;66;1366607790;1572640853;206033063
4194304;10;67;1593056079;1798972554;205916475
4194304;10;68;1819708904;2024099649;204390745
4194304;10;69;2044930683;2249960633;205029950
4194304;10;70;2270264526;2476131427;205866901
4194304;10;71;2496670913;2702443629;205772716
4194304;10;72;2722912252;2929303683;206391431
4194304;10;73;2949857720;3155298520;205440800
4194304;10;74;3175938171;3383415817;207477646
4194304;10;75;3404255965;3610751604;206495639
4194304;10;76;3631289948;3835751115;204461167
4194304;10;77;3856109866;4063354241;207244375
4194304;10;78;4084852166;4289826451;204974285
4194304;10;79;15553099;219802025;204248926
4194304;10;80;240143584;444727864;204584280
4194304;10;81;467174734;676842939;209668205
4194304;10;82;698440888;903074827;204633939
4194304;10;83;923462610;1128212369;204749759
4194304;10;84;1149713347;1355127089;205413742
4194304;10;85;1375501260;1580528292;205027032
4194304;10;86;1600789095;1807357595;206568500
4194304;10;87;1827730911;2032234407;204503496
4194304;10;88;2052793586;2256939586;204146000
4194304;10;89;2277070056;2480512874;203442818
4194304;10;90;2500868354;2705224144;204355790
4194304;10;91;2725556511;2932292766;206736255
4194304;10;92;2952653990;3156893602;204239612
4194304;10;93;3177496884;3382583569;205086685
4194304;10;94;3403206221;3607601584;204395363
4194304;10;95;3628100164;3833114149;205013985
4194304;10;96;3853520906;4058674170;205153264
4194304;10;97;4079226067;4283532583;204306516
4194304;10;98;9005611;213445677;204440066
4194304;10;99;233966750;439236875;205270125
4194304;10;0;465264604;670786926;205522322
4194304;10;1;691190890;895696984;204506094
4194304;10;2;916043081;1119777067;203733986
4194304;10;3;1140391988;1344413947;204021959
4194304;10;4;1364796208;1569679590;204883382
4194304;10;5;1591026009;1795637179;204611170
4194304;10;6;1816078134;2020297849;204219715
4194304;10;7;2040560512;2243982047;203421535
4194304;10;8;2264373290;2470462444;206089154
4194304;10;9;2490740018;2694173979;203433961
4194304;10;10;2715929341;2923838467;207909126
4194304;10;11;2944915272;3149303511;204388239
4194304;10;12;3169693446;3375201827;205508381
4194304;10;13;3395853650;3600203274;204349624
4194304;10;14;3620532811;3825649894;205117083
4194304;10;15;3846003570;4052338746;206335176
4194304;10;16;4072766375;4276698122;203931747
4194304;10;17;2539249;207485160;204945911
4194304;10;18;227954441;433183671;205229230
4194304;10;19;453479448;662327473;208848025
4194304;10;20;682756060;887250658;204494598
4194304;10;21;908146179;1113776864;205630685
4194304;10;22;1134213739;1340069573;205855834
4194304;10;23;1360426076;1601875553;241449477
4194304;10;24;1623539652;1845574736;222035084
4194304;10;25;1866412602;2072509241;206096639
4194304;10;26;2093339011;2301493600;208154589
4194304;10;27;2322014871;2528011074;205996203
4194304;10;28;2548745820;2753924843;205179023
4194304;10;29;2774837889;2979675713;204837824
4194304;10;30;3000093187;3205815569;205722382
4194304;10;31;3226959394;3432868503;205909109
4194304;10;32;3453783250;3661906426;208123176
4194304;10;33;3682243592;3888505177;206261585
4194304;10;34;3909360066;4116873135;207513069
4194304;10;35;4137404217;47330437;204893516
4194304;10;36;67757511;273805756;206048245
4194304;10;37;294880401;500324903;205444502
4194304;10;38;520929461;727632320;206702859
4194304;10;39;747947778;954490652;206542874
4194304;10;40;976356702;1181655816;205299114
4194304;10;41;1202414292;1407259498;204845206
4194304;10;42;1427815702;1632435678;204619976
4194304;10;43;1653491521;1858767896;205276375
4194304;10;44;1879223603;2084175136;204951533
4194304;10;45;2104676823;2309658166;204981343
4194304;10;46;2330053689;2538552515;208498826
4194304;10;47;2559215243;2764080062;204864819
4194304;10;48;2784643315;2990037667;205394352
4194304;10;49;3010785301;3215828726;205043425
4194304;10;50;3236616329;3442855046;206238717
4194304;10;51;3463254783;3668772236;205517453
4194304;10;52;3689206275;3933825465;244619190
4194304;10;53;3955038460;4172459134;217420674
4194304;10;54;4193162613;103202586;205007269
4194304;10;55;123782216;328281054;204498838
4194304;10;56;348836471;554418209;205581738
4194304;10;57;574598012;780786555;206188543
4194304;10;58;801178929;1005889467;204710538
4194304;10;59;1027318887;1233404575;206085688
4194304;10;60;1255183786;1460853472;205669686
4194304;10;61;1481375177;1686119123;204743946
4194304;10;62;1706883546;1912742646;205859100
4194304;10;63;1933098930;2137842846;204743916
4194304;10;64;2158368045;2365090819;206722774
4194304;10;65;2385484645;2591521789;206037144
4194304;10;66;2612181539;2818146231;205964692
4194304;10;67;2839560477;3045177447;205616970
4194304;10;68;3065864566;3271711397;205846831
4194304;10;69;3292428170;3498204478;205776308
4194304;10;70;3518555031;3724826327;206271296
4194304;10;71;3745379647;3951111729;205732082
4194304;10;72;3971677841;4177599916;205922075
4194304;10;73;4198422006;109529764;206075054
4194304;10;74;129776318;352521051;222744733
4194304;10;75;374149965;591966937;217816972
4194304;10;76;613544755;819155591;205610836
4194304;10;77;839637881;1045120643;205482762
4194304;10;78;1065435646;1270976611;205540965
4194304;10;79;1291547114;1496331314;204784200
4194304;10;80;1517466521;1722768758;205302237
4194304;10;81;1743170109;1948730138;205560029
4194304;10;82;1969142243;2173851903;204709660
4194304;10;83;2194410576;2398593008;204182432
4194304;10;84;2418911818;2623580162;204668344
4194304;10;85;2643880491;2849150226;205269735
4194304;10;86;2869654683;3075365783;205711100
4194304;10;87;3095951479;3304044812;208093333
4194304;10;88;3324410784;3531168850;206758066
4194304;10;89;3551683157;3757988449;206305292
4194304;10;90;3778301277;3982752256;204450979
4194304;10;91;4003378837;4208712704;205333867
4194304;10;92;4229042959;139849893;205774230
4194304;10;93;160211006;365595292;205384286
4194304;10;94;386377994;591259060;204881066
4194304;10;95;612273646;817084818;204811172
4194304;10;96;837467481;1042619953;205152472
4194304;10;97;1063092741;1268305346;205212605
4194304;10;98;1288678453;1493696477;205018024
4194304;10;99;1514750471;1720385055;205634584
4194304;10;0;2026542584;2871463273;844920689
4194304;10;1;2955967747;3804613549;848645802
4194304;10;2;3888155605;442463142;849274833
4194304;10;3;528128378;1425449407;897321029
4194304;10;4;1509561908;2353532497;843970589
4194304;10;5;2437814621;3281843516;844028895
4194304;10;6;3366301836;4215486787;849184951
4194304;10;7;4195550;847718672;843523122
4194304;10;8;931796800;1775240560;843443760
4194304;10;9;1859319653;2704583845;845264192
4194304;10;10;2789979996;3633476940;843496944
4194304;10;11;3722103797;273545074;846408573
4194304;10;12;357936011;1224901416;866965405
4194304;10;13;1309974650;2162063236;852088586
4194304;10;14;2249221974;3096072675;846850701
4194304;10;15;3180120010;4031308645;851188635
4194304;10;16;4117274587;669728244;847420953
4194304;10;17;757479150;1613930949;856451799
4194304;10;18;1698669945;2542094133;843424188
4194304;10;19;2626733877;3496987911;870254034
4194304;10;20;3581069105;130531964;844430155
4194304;10;21;216684630;1067888248;851203618
4194304;10;22;1152953538;2034470323;881516785
4194304;10;23;2120468442;2974387427;853918985
4194304;10;24;3061298183;3904615460;843317277
4194304;10;25;3991060451;546046455;849953300
4194304;10;26;632764617;1483700582;850935965
4194304;10;27;1567359709;2410992551;843632842
4194304;10;28;2495376627;3341425015;846048388
4194304;10;29;3425525484;4269130557;843605073
4194304;10;30;58099867;901673529;843573662
4194304;10;31;986387137;1826670853;840283716
4194304;10;32;1910443456;2752275500;841832044
4194304;10;33;2836221195;3676654790;840433595
4194304;10;34;3760600942;310005781;844372135
4194304;10;35;394420196;1238442756;844022560
4194304;10;36;1322438227;2164777891;842339664
4194304;10;37;2249072179;3093357044;844284865
4194304;10;38;3177697113;4021851391;844154278
4194304;10;39;4106654972;654774256;843086580
4194304;10;40;739600393;1585746383;846145990
4194304;10;41;1669124729;2510764991;841640262
4194304;10;42;2595191182;3702976072;1107784890
4194304;10;43;3788592331;343987909;850362874
4194304;10;44;427842487;1433593883;1005751396
4194304;10;45;1527586751;2384803144;857216393
4194304;10;46;2468902210;3351979506;883077296
4194304;10;47;3436925000;4285921504;848996504
4194304;10;48;75026744;919645526;844618782
4194304;10;49;1003283927;1873172155;869888228
4194304;10;50;1959064805;2809740436;850675631
4194304;10;51;2893691991;3739447643;845755652
4194304;10;52;3823931006;374083484;845119774
4194304;10;53;460145637;1326097577;865951940
4194304;10;54;1411866453;2269169417;857302964
4194304;10;55;2353286714;3197238083;843951369
4194304;10;56;3281236783;4127374682;846137899
4194304;10;57;4212179914;761181563;843968945
4194304;10;58;845395879;1691584521;846188642
4194304;10;59;1775302839;2603390953;828088114
4194304;10;60;2634680139;2950661450;315981311
4194304;10;61;2982027518;3275962553;293935035
4194304;10;62;3305596044;3601206257;295610213
4194304;10;63;3630510085;3928402394;297892309
4194304;10;64;3958083907;4260603490;302519583
4194304;10;65;4291787362;304429105;307609039
4194304;10;66;334143730;631622220;297478490
4194304;10;67;661043893;957641200;296597307
4194304;10;68;989698302;1302491778;312793476
4194304;10;69;1331868313;1632993615;301125302
4194304;10;70;1662155495;1957196867;295041372
4194304;10;71;1987542278;2279966807;292424529
4194304;10;72;2317550763;2628964037;311413274
4194304;10;73;2658351264;2951697823;293346559
4194304;10;74;2980877263;3276232200;295354937
4194304;10;75;3305458049;3603148941;297690892
4194304;10;76;3632714848;3926262829;293547981
4194304;10;77;3955737182;4294102527;338365345
4194304;10;78;30206429;335514092;305307663
4194304;10;79;365143936;658693104;293549168
4194304;10;80;687791011;981967635;294176624
4194304;10;81;1011002470;1307618568;296616098
4194304;10;82;1337199608;1629586978;292387370
4194304;10;83;1659070986;1953573406;294502420
4194304;10;84;1982708521;2275092487;292383966
4194304;10;85;2304151110;2603208800;299057690
4194304;10;86;2632447915;2925611133;293163218
4194304;10;87;2955385163;3258064372;302679209
4194304;10;88;3287810178;3600526229;312716051
4194304;10;89;3631977879;3927269697;295291818
4194304;10;90;3956850675;4249573385;292722710
4194304;10;91;4278801399;279991353;296157250
4194304;10;92;309349639;602628010;293278371
4194304;10;93;631656154;923858677;292202523
4194304;10;94;952883820;1249094160;296210340
4194304;10;95;1285106589;1580448334;295341745
4194304;10;96;1609500914;1903034035;293533121
4194304;10;97;1932079979;2225142468;293062489
4194304;10;98;2254189641;2547641219;293451578
4194304;10;99;2576911470;2869076920;292165450
8388608;10;0;2932836261;3348746627;415910366
8388608;10;1;3384532680;3743259917;358727237
8388608;10;2;3779125239;4137033036;357907797
8388608;10;3;4172655372;239021676;361333600
8388608;10;4;280405050;651643745;371238695
8388608;10;5;689358162;1060592972;371234810
8388608;10;6;1096349410;1508971971;412622561
8388608;10;7;1554165548;1974059703;419894155
8388608;10;8;2015571942;2430052939;414480997
8388608;10;9;2472129890;2888154777;416024887
8388608;10;10;2929631773;3315255509;385623736
8388608;10;11;3356634556;3743239856;386605300
8388608;10;12;3779626066;4140348965;360722899
8388608;10;13;4176016786;239952895;358903405
8388608;10;14;275738549;657046365;381307816
8388608;10;15;692833594;1053178037;360344443
8388608;10;16;1089276040;1454498756;365222716
8388608;10;17;1491279914;1855157334;363877420
8388608;10;18;1891782715;2255501225;363718510
8388608;10;19;2291350509;2662548729;371198220
8388608;10;20;2698907351;3057113112;358205761
8388608;10;21;3092695898;3458588985;365893087
8388608;10;22;3494997693;3856748122;361750429
8388608;10;23;3892717170;4273621786;380904616
8388608;10;24;17115815;383335800;366219985
8388608;10;25;428547193;835331532;406784339
8388608;10;26;871348317;1261290008;389941691
8388608;10;27;1299384235;1691064814;391680579
8388608;10;28;1727821209;2094131237;366310028
8388608;10;29;2130379717;2491703272;361323555
8388608;10;30;2528487609;2893956020;365468411
8388608;10;31;2929510881;3291244128;361733247
8388608;10;32;3327493032;3721673673;394180641
8388608;10;33;3763616389;4164663384;401046995
8388608;10;34;4200322769;265359159;360003686
8388608;10;35;301508850;659430787;357921937
8388608;10;36;695072148;1091906034;396833886
8388608;10;37;1133307511;1506908971;373601460
8388608;10;38;1543051803;1924075243;381023440
8388608;10;39;1960391513;2341296589;380905076
8388608;10;40;2377082464;2734921382;357838918
8388608;10;41;2770702946;3139625280;368922334
8388608;10;42;3176491450;3537342880;360851430
8388608;10;43;3573300447;3933562208;360261761
8388608;10;44;3969662344;35404608;360709560
8388608;10;45;71434277;439994701;368560424
8388608;10;46;475723647;884723440;408999793
8388608;10;47;927797160;1326671723;398874563
8388608;10;48;1365222124;1733228031;368005907
8388608;10;49;1769997382;2137572376;367574994
8388608;10;50;2176494294;2584003513;407509219
8388608;10;51;2626186645;3010322562;384135917
8388608;10;52;3047789897;3410386481;362596584
8388608;10;53;3446957922;3811298931;364341009
8388608;10;54;3847643216;4208034900;360391684
8388608;10;55;4243912700;312526256;363580852
8388608;10;56;348765488;713962116;365196628
8388608;10;57;749935474;1132167087;382231613
8388608;10;58;1168528753;1530145016;361616263
8388608;10;59;1566060394;1931525942;365465548
8388608;10;60;1967407418;2359794792;392387374
8388608;10;61;2396533067;2755892569;359359502
8388608;10;62;2792003209;3151290609;359287400
8388608;10;63;3186867966;3575113695;388245729
8388608;10;64;3616671397;4003413418;386742021
8388608;10;65;4044998111;117390181;367359366
8388608;10;66;153626788;514214668;360587880
8388608;10;67;550703504;911335805;360632301
8388608;10;68;947414294;1338631998;391217704
8388608;10;69;1380065440;1757403444;377338004
8388608;10;70;1793777059;2152875046;359097987
8388608;10;71;2191197296;2561204625;370007329
8388608;10;72;2596932814;2974758645;377825831
8388608;10;73;3010625635;3369431758;358806123
8388608;10;74;3405692726;3764018418;358325692
8388608;10;75;3799990804;4157838715;357847911
8388608;10;76;4193456775;257594860;359105381
8388608;10;77;293337749;652754270;359416521
8388608;10;78;688424310;1047094038;358669728
8388608;10;79;1082736992;1445337194;362600202
8388608;10;80;1481461665;1846169990;364708325
8388608;10;81;1882521612;2270979357;388457745
8388608;10;82;2309302751;2688317409;379014658
8388608;10;83;2725805721;3092216681;366410960
8388608;10;84;3128801486;3493252438;364450952
8388608;10;85;3528853489;3889356467;360502978
8388608;10;86;3925029248;5287045;375225093
8388608;10;87;43401909;427188456;383786547
8388608;10;88;468668161;857373367;388705206
8388608;10;89;899459122;1284351775;384892653
8388608;10;90;1321100773;1707198055;386097282
8388608;10;91;1749608142;2175756858;426148716
8388608;10;92;2218035857;2611189490;393153633
8388608;10;93;2647644273;3012201663;364557390
8388608;10;94;3048088788;3412980670;364891882
8388608;10;95;3455740663;3833084546;377343883
8388608;10;96;3869201391;4273891450;404690059
8388608;10;97;20520297;437056661;416536364
8388608;10;98;478557046;895386150;416829104
8388608;10;99;936964355;1353444834;416480479
8388608;10;0;1401557586;1818096314;416538728
8388608;10;1;1859651369;2228048038;368396669
8388608;10;2;2264628914;2638329821;373700907
8388608;10;3;2674558225;3040103239;365545014
8388608;10;4;3076168671;3470472288;394303617
8388608;10;5;3506272990;3878157700;371884710
8388608;10;6;3914306734;4278397361;364090627
8388608;10;7;19350849;381800338;362449489
8388608;10;8;418488602;785359696;366871094
8388608;10;9;822148058;1183598747;361450689
8388608;10;10;1221763625;1603849668;382086043
8388608;10;11;1641550422;2007613759;366063337
8388608;10;12;2047078688;2414220143;367141455
8388608;10;13;2450922938;2811498981;360576043
8388608;10;14;2847583996;3258874271;411290275
8388608;10;15;3301717961;3680109792;378391831
8388608;10;16;3723442568;4084797417;361354849
8388608;10;17;4131723798;217284494;380527992
8388608;10;18;254245094;618294754;364049660
8388608;10;19;654943082;1015978842;361035760
8388608;10;20;1051827285;1413647874;361820589
8388608;10;21;1449724567;1825222482;375497915
8388608;10;22;1861266470;2225531713;364265243
8388608;10;23;2262059623;2643175678;381116055
8388608;10;24;2680004547;3054240042;374235495
8388608;10;25;3089913673;3451790282;361876609
8388608;10;26;3488194333;3876268329;388073996
8388608;10;27;3917825379;1394224;378536141
8388608;10;28;37416497;399225989;361809492
8388608;10;29;436113529;799769436;363655907
8388608;10;30;836095900;1234224541;398128641
8388608;10;31;1279461462;1664166873;384705411
8388608;10;32;1700381074;2086501089;386120015
8388608;10;33;2124716145;2495148629;370432484
8388608;10;34;2531122924;2889608573;358485649
8388608;10;35;2925528723;3289604338;364075615
8388608;10;36;3331956303;3731734606;399778303
8388608;10;37;3767530620;4129568495;362037875
8388608;10;38;4165770660;229517398;358714034
8388608;10;39;265379763;630760029;365380266
8388608;10;40;669400277;1061589429;392189152
8388608;10;41;1099573000;1465109243;365536243
8388608;10;42;1501764594;1863722136;361957542
8388608;10;43;1900238479;2262750269;362511790
8388608;10;44;2298826353;2662826197;363999844
8388608;10;45;2699379852;3063681265;364301413
8388608;10;46;3099323572;3459624724;360301152
8388608;10;47;3495221049;3883747412;388526363
8388608;10;48;3928461945;4291972789;363510844
8388608;10;49;33838295;452323608;418485313
8388608;10;50;488190303;866462152;378271849
8388608;10;51;905134670;1277985687;372851017
8388608;10;52;1314542125;1679592885;365050760
8388608;10;53;1715930029;2082195369;366265340
8388608;10;54;2118511774;2484748202;366236428
8388608;10;55;2521134631;2904625087;383490456
8388608;10;56;2944351672;3313175460;368823788
8388608;10;57;3349063474;3712530943;363467469
8388608;10;58;3748321014;4112968282;364647268
8388608;10;59;4149060949;238479094;384385441
8388608;10;60;281571546;705157380;423585834
8388608;10;61;746848905;1146163476;399314571
8388608;10;62;1182611457;1557958364;375346907
8388608;10;63;1594235113;1967988868;373753755
8388608;10;64;2009718108;2397448647;387730539
8388608;10;65;2433081570;2791181205;358099635
8388608;10;66;2826911364;3187936903;361025539
8388608;10;67;3224303396;3594259388;369955992
8388608;10;68;3630955369;4018186373;387231004
8388608;10;69;4056659457;121854674;360162513
8388608;10;70;159076948;521963993;362887045
8388608;10;71;558261366;917300887;359039521
8388608;10;72;954077506;1325486016;371408510
8388608;10;73;1363075546;1732920749;369845203
8388608;10;74;1769121771;2133813420;364691649
8388608;10;75;2169417240;2573968886;404551646
8388608;10;76;2616778846;3039480657;422701811
8388608;10;77;3081168668;3467320266;386151598
8388608;10;78;3503497754;3865600558;362102804
8388608;10;79;3907793885;4274843980;367050095
8388608;10;80;15477588;373744786;358267198
8388608;10;81;409901858;775778576;365876718
8388608;10;82;811956155;1172142923;360186768
8388608;10;83;1208303709;1567039279;358735570
8388608;10;84;1602905117;1965703277;362798160
8388608;10;85;2002127312;2373859846;371732534
8388608;10;86;2412234880;2794535380;382300500
8388608;10;87;2834459346;3197289910;362830564
8388608;10;88;3233586674;3591264963;357678289
8388608;10;89;3627516040;3987376358;359860318
8388608;10;90;4023793753;94310706;365484249
8388608;10;91;131202421;494159205;362956784
8388608;10;92;534809035;898794790;363985755
8388608;10;93;934822550;1293666854;358844304
8388608;10;94;1329758087;1694357569;364599482
8388608;10;95;1730936369;2097048046;366111677
8388608;10;96;2132801574;2500827915;368026341
8388608;10;97;2537351044;2902963132;365612088
8388608;10;98;2939405983;3305362507;365956524
8388608;10;99;3343168374;3730291900;387123526
8388608;10;0;4052840604;449137611;691264303
8388608;10;1;517546469;1198077091;680530622
8388608;10;2;1266286888;1956849565;690562677
8388608;10;3;2025751753;2718192903;692441150
8388608;10;4;2786697060;3476124375;689427315
8388608;10;5;3544077580;4287943969;743866389
8388608;10;6;61460958;747467855;686006897
8388608;10;7;816864245;1502589252;685725007
8388608;10;8;1571049206;2254893041;683843835
8388608;10;9;2323441324;3010613664;687172340
8388608;10;10;3079157014;3767611682;688454668
8388608;10;11;3836044109;230355865;689279052
8388608;10;12;298938810;981689128;682750318
8388608;10;13;1050846631;1755415165;704568534
8388608;10;14;1824244036;2521142218;696898182
8388608;10;15;2590788181;3291242988;700454807
8388608;10;16;3359582352;4048501116;688918764
8388608;10;17;4117187007;566719405;744499694
8388608;10;18;635755725;1323731175;687975450
8388608;10;19;1392041129;2077424873;685383744
8388608;10;20;2145669888;2840182411;694512523
8388608;10;21;2908038458;3595540329;687501871
8388608;10;22;3663354639;59270163;690882820
8388608;10;23;128540502;864890166;736349664
8388608;10;24;937142861;1635241837;698098976
8388608;10;25;1704974071;2399737629;694763558
8388608;10;26;2468882366;3154228738;685346372
8388608;10;27;3223714171;3910987363;687273192
8388608;10;28;3979385399;370120871;685702768
8388608;10;29;438764095;1125199333;686435238
8388608;10;30;1193607515;1879952097;686344582
8388608;10;31;1948233441;2638908501;690675060
8388608;10;32;2707392177;3394035211;686643034
8388608;10;33;3462598972;4152728773;690129801
8388608;10;34;4221386594;614756575;688337277
8388608;10;35;685767222;1377329816;691562594
8388608;10;36;1446382694;2133527072;687144378
8388608;10;37;2202259582;2888992178;686732596
8388608;10;38;2957311990;3641417007;684105017
8388608;10;39;3709181757;102516120;688301659
8388608;10;40;171833114;861817172;689984058
8388608;10;41;930245184;1617781934;687536750
8388608;10;42;1686553443;2371416816;684863373
8388608;10;43;2439488513;3134526771;695038258
8388608;10;44;3202891436;3934413730;731522294
8388608;10;45;4011310145;412856851;696514002
8388608;10;46;480719406;1178870170;698150764
8388608;10;47;1252260651;2008656609;756395958
8388608;10;48;2077907162;2771494521;693587359
8388608;10;49;2840953898;3536794367;695840469
8388608;10;50;3606153505;4294934390;688780885
8388608;10;51;67931592;755984547;688052955
8388608;10;52;825386779;1520145614;694758835
8388608;10;53;1590523347;2286132264;695608917
8388608;10;54;2355546125;3040049263;684503138
8388608;10;55;3107836233;3793463900;685627667
8388608;10;56;3862512753;261083110;693537653
8388608;10;57;330363305;1021638048;691274743
8388608;10;58;1090626671;1783310379;692683708
8388608;10;59;1851997369;2544166800;692169431
8388608;10;60;2612102144;3303407327;691305183
8388608;10;61;3372335692;4064763194;692427502
8388608;10;62;4133859825;523461663;684569134
8388608;10;63;592748905;1286063699;693314794
8388608;10;64;1355463499;2119796782;764333283
8388608;10;65;2189833722;2878080670;688246948
8388608;10;66;2946818064;3629671250;682853186
8388608;10;67;3700044532;105579742;700502506
8388608;10;68;173334017;860578418;687244401
8388608;10;69;929345450;1618974519;689629069
8388608;10;70;1687507191;2377836382;690329191
8388608;10;71;2446100731;3137973624;691872893
8388608;10;72;3205909326;3900256251;694346925
8388608;10;73;3968005884;360863953;687825365
8388608;10;74;428698195;1166224660;737526465
8388608;10;75;1234458774;1925754805;691296031
8388608;10;76;1993626149;2686107352;692481203
8388608;10;77;2755078874;3445454281;690375407
8388608;10;78;3513328901;4203878056;690549155
8388608;10;79;4273192148;722208117;743983265
8388608;10;80;794481576;1491234367;696752791
8388608;10;81;1561567411;2258224789;696657378
8388608;10;82;2326984178;3022368119;695383941
8388608;10;83;3090924312;3779958403;689034091
8388608;10;84;3847763536;241503169;688706929
8388608;10;85;310118299;1007946931;697828632
8388608;10;86;1078963651;1772078612;693114961
8388608;10;87;1841419354;2530070561;688651207
8388608;10;88;2599314606;3287310338;687995732
8388608;10;89;3356814976;4058777496;701962520
8388608;10;90;4128127366;521398913;688238843
8388608;10;91;589704028;1275622777;685918749
8388608;10;92;1344339232;2031685185;687345953
8388608;10;93;2100788974;2788116930;687327956
8388608;10;94;2858442716;3549416606;690973890
8388608;10;95;3645633739;120897946;770231503
8388608;10;96;194922277;921938816;727016539
8388608;10;97;991450288;1697437714;705987426
8388608;10;98;1769678352;2457893931;688215579
8388608;10;99;2526683183;3224155699;697472516
